,CustomerID,Recency(Days),Frequency,Monetory,Recency(Days)Score,FrequencyScore,MonetoryScore,RFM,Loyality_Level
0,2,4,182,553704,1,1,1,3,Platinum
1,3,77,27,257404,3,3,1,7,Gold
2,4,19,72,176613,1,2,2,5,Platinum
3,5,311,16,41976,4,4,3,11,Bronze
4,6,37,77,166972,2,2,2,6,Gold
5,7,208,4,9410,4,4,4,12,Bronze
6,8,233,58,135550,4,2,2,8,Gold
7,9,215,13,65832,4,4,3,11,Bronze
8,10,25,58,331601,2,2,1,5,Platinum
9,11,34,131,771439,2,1,1,4,Platinum
10,12,2,17,105674,1,4,2,7,Gold
11,13,58,248,718751,3,1,1,5,Platinum
12,14,53,126,281630,3,1,1,5,Platinum
13,15,288,9,21630,4,4,4,12,Bronze
14,16,4,256,586496,1,1,1,3,Platinum
15,17,110,23,78378,3,3,3,9,Silver
16,18,8,81,205212,1,2,2,5,Platinum
17,19,292,21,41055,4,3,3,10,Silver
18,20,6,10,23537,1,4,4,9,Silver
19,21,52,166,469518,2,1,1,4,Platinum
20,22,60,62,182448,3,2,2,7,Gold
21,23,72,49,163883,3,2,2,7,Gold
22,24,312,13,42424,4,4,3,11,Bronze
23,25,26,32,76012,2,3,3,8,Gold
24,26,11,15,47600,1,4,3,8,Gold
25,27,316,76,200342,4,2,2,8,Gold
26,28,130,219,518776,3,1,1,5,Platinum
27,29,83,38,93904,3,3,2,8,Gold
28,30,22,100,296416,2,2,1,5,Platinum
29,31,10,82,183732,1,2,2,5,Platinum
30,32,190,94,236899,4,2,1,7,Gold
31,33,29,25,47632,2,3,3,8,Gold
32,34,346,10,57670,4,4,3,11,Bronze
33,35,16,100,356353,1,2,1,4,Platinum
34,36,80,31,68598,3,3,3,9,Silver
35,37,22,100,60518,2,2,3,7,Gold
36,38,73,64,201327,3,2,2,7,Gold
37,39,66,25,148768,3,3,2,8,Gold
38,40,20,144,386528,2,1,1,4,Platinum
39,41,36,124,287355,2,1,1,4,Platinum
40,42,46,84,215492,2,2,1,5,Platinum
41,43,120,55,158398,3,2,2,7,Gold
42,44,308,4,7278,4,4,4,12,Bronze
43,45,324,10,25584,4,4,4,12,Bronze
44,46,52,4,42252,2,4,3,9,Silver
45,47,149,53,178467,4,2,2,8,Gold
46,48,23,105,429407,2,1,1,4,Platinum
47,49,50,72,222570,2,2,1,5,Platinum
48,50,33,101,332786,2,1,1,4,Platinum
49,51,79,109,1385284,3,1,1,5,Platinum
50,52,309,25,61000,4,3,3,10,Silver
51,53,75,58,157322,3,2,2,7,Gold
52,54,68,36,81494,3,3,3,9,Silver
53,55,219,15,57781,4,4,3,11,Bronze
54,56,25,699,14385095,2,1,1,4,Platinum
55,57,4,183,392340,1,1,1,3,Platinum
56,58,113,34,86360,3,3,2,8,Gold
57,59,65,29,80913,3,3,3,9,Silver
58,60,16,41,87913,1,3,2,6,Gold
59,61,96,38,91062,3,3,2,8,Gold
60,62,3,117,229979,1,1,1,3,Platinum
61,63,163,30,200188,4,3,2,9,Silver
62,64,79,36,97807,3,3,2,8,Gold
63,65,195,29,62672,4,3,3,10,Silver
64,66,24,28,101608,2,3,2,7,Gold
65,67,26,287,804536,2,1,1,4,Platinum
66,68,10,94,407444,1,2,1,4,Platinum
67,69,45,10,27584,2,4,4,10,Silver
68,70,38,234,795826,2,1,1,4,Platinum
69,71,43,107,526849,2,1,1,4,Platinum
70,72,1,420,1870543,1,1,1,3,Platinum
71,73,85,50,99632,3,2,2,7,Gold
72,74,80,36,896714,3,3,1,7,Gold
73,75,102,15,52453,3,4,3,10,Silver
74,76,3,184,566503,1,1,1,3,Platinum
75,77,15,96,304853,1,2,1,4,Platinum
76,78,367,10,21144,4,4,4,12,Bronze
77,79,4,11,21598,1,4,4,9,Silver
78,80,22,173,465037,2,1,1,4,Platinum
79,81,25,3,9948,2,4,4,10,Silver
80,82,58,57,117966,3,2,2,7,Gold
81,83,244,25,53855,4,3,3,10,Silver
82,84,45,21,48432,2,3,3,8,Gold
83,85,23,187,435921,2,1,1,4,Platinum
84,86,163,8,26814,4,4,4,12,Bronze
85,87,12,353,1230748,1,1,1,3,Platinum
86,88,17,20,41312,1,3,3,7,Gold
87,89,135,43,95624,3,2,2,7,Gold
88,90,57,15,389836,3,4,1,8,Gold
89,91,74,85,335450,3,2,1,6,Gold
90,92,45,122,331818,2,1,1,4,Platinum
91,93,73,60,251417,3,2,1,6,Gold
92,94,73,36,108842,3,3,2,8,Gold
93,95,155,34,76450,4,3,3,10,Silver
94,96,19,60,124824,1,2,2,5,Platinum
95,97,54,79,164513,3,2,2,7,Gold
96,98,11,22,99624,1,3,2,6,Gold
97,99,19,45,88594,1,2,2,5,Platinum
98,100,188,36,85862,4,3,3,10,Silver
99,101,3,438,2049141,1,1,1,3,Platinum
100,102,33,332,820111,2,1,1,4,Platinum
101,103,54,161,391713,3,1,1,5,Platinum
102,104,18,408,919351,1,1,1,3,Platinum
103,105,54,35,95322,3,3,2,8,Gold
104,106,16,224,724773,1,1,1,3,Platinum
105,107,23,300,1499405,2,1,1,4,Platinum
106,108,4,35,68029,1,3,3,7,Gold
107,109,12,30,63304,1,3,3,7,Gold
108,110,29,150,375459,2,1,1,4,Platinum
109,111,23,209,674016,2,1,1,4,Platinum
110,112,18,68,249088,1,2,1,4,Platinum
111,113,36,342,508503,2,1,1,4,Platinum
112,114,10,54,155349,1,2,2,5,Platinum
113,115,337,14,35243,4,4,4,12,Bronze
114,116,6,235,631870,1,1,1,3,Platinum
115,117,39,25,57912,2,3,3,8,Gold
116,118,65,18,32436,3,3,4,10,Silver
117,119,166,21,52584,4,3,3,10,Silver
118,120,16,71,145236,1,2,2,5,Platinum
119,121,82,13,162800,3,4,2,9,Silver
120,122,22,21,41174,2,3,3,8,Gold
121,123,24,52,544504,2,2,1,5,Platinum
122,124,337,148,283173,4,1,1,6,Gold
123,125,96,142,335427,3,1,1,5,Platinum
124,127,19,8,46139,1,4,3,8,Gold
125,129,234,23,8398,4,3,4,11,Bronze
126,130,135,20,136785,3,3,2,8,Gold
127,131,27,69,53515,2,2,3,7,Gold
128,132,288,6,17688,4,4,4,12,Bronze
129,133,145,31,100745,4,3,2,9,Silver
130,134,67,34,18915,3,3,4,10,Silver
131,135,113,34,79676,3,3,3,9,Silver
132,136,268,51,125408,4,2,2,8,Gold
133,137,354,15,35685,4,4,4,12,Bronze
134,138,78,24,160118,3,3,2,8,Gold
135,139,29,281,302273,2,1,1,4,Platinum
136,140,1,119,253627,1,1,1,3,Platinum
137,141,65,17,35580,3,4,4,11,Bronze
138,142,80,147,311756,3,1,1,5,Platinum
139,143,143,37,68427,3,3,3,9,Silver
140,144,40,10,29723,2,4,4,10,Silver
141,145,20,102,212349,2,1,1,4,Platinum
142,146,15,136,593226,1,1,1,3,Platinum
143,147,1,68,151615,1,2,2,5,Platinum
144,148,86,17,46012,3,4,3,10,Silver
145,149,10,86,204647,1,2,2,5,Platinum
146,150,60,62,191646,3,2,2,7,Gold
147,151,15,17,14983,1,4,4,9,Silver
148,152,31,15,38806,2,4,4,10,Silver
149,153,131,62,131589,3,2,2,7,Gold
150,154,92,34,85411,3,3,3,9,Silver
151,155,60,259,579052,3,1,1,5,Platinum
152,156,30,21,45271,2,3,3,8,Gold
153,157,23,273,662579,2,1,1,4,Platinum
154,158,20,461,1500798,2,1,1,4,Platinum
155,159,30,49,119829,2,2,2,6,Gold
156,160,37,18,36682,2,3,4,9,Silver
157,161,76,48,109849,3,2,2,7,Gold
158,162,47,67,134154,2,2,2,6,Gold
159,163,207,6,21996,4,4,4,12,Bronze
160,164,167,4,8088,4,4,4,12,Bronze
161,165,80,56,111488,3,2,2,7,Gold
162,166,358,10,21970,4,4,4,12,Bronze
163,167,40,19,38249,2,3,4,9,Silver
164,168,9,182,424920,1,1,1,3,Platinum
165,169,51,121,78463,2,1,3,6,Gold
166,170,21,27,544128,2,3,1,6,Gold
167,171,9,11,38522,1,4,4,9,Silver
168,172,314,20,66350,4,3,3,10,Silver
169,173,6,103,242772,1,1,1,3,Platinum
170,174,304,16,29545,4,4,4,12,Bronze
171,175,10,161,426744,1,1,1,3,Platinum
172,176,263,20,46932,4,3,3,10,Silver
173,177,289,9,18526,4,4,4,12,Bronze
174,178,87,18,43596,3,3,3,9,Silver
175,179,23,438,1068073,2,1,1,4,Platinum
176,180,4,157,403568,1,1,1,3,Platinum
177,181,40,34,80348,2,3,3,8,Gold
178,182,9,58,112008,1,2,2,5,Platinum
179,183,228,28,19601,4,3,4,11,Bronze
180,184,316,10,21914,4,4,4,12,Bronze
181,185,36,88,179968,2,2,2,6,Gold
182,186,36,146,91914,2,1,2,5,Platinum
183,187,22,112,305723,2,1,1,4,Platinum
184,188,79,28,51894,3,3,3,9,Silver
185,189,247,23,48818,4,3,3,10,Silver
186,190,40,14,26300,2,4,4,10,Silver
187,191,239,20,49548,4,3,3,10,Silver
188,192,3,232,940065,1,1,1,3,Platinum
189,193,6,95,245289,1,2,1,4,Platinum
190,194,235,85,253024,4,2,1,7,Gold
191,195,18,11,21761,1,4,4,9,Silver
192,196,9,3,11840,1,4,4,9,Silver
193,197,40,9,19257,2,4,4,10,Silver
194,198,30,33,72872,2,3,3,8,Gold
195,199,212,67,1126330,4,2,1,7,Gold
196,200,318,25,48876,4,3,3,10,Silver
197,201,94,16,56894,3,4,3,10,Silver
198,202,110,20,49189,3,3,3,9,Silver
199,203,47,114,406263,2,1,1,4,Platinum
200,204,52,25,73777,2,3,3,8,Gold
201,205,20,202,434069,2,1,1,4,Platinum
202,206,10,127,381333,1,1,1,3,Platinum
203,207,30,55,136620,2,2,2,6,Gold
204,208,29,54,266897,2,2,1,5,Platinum
205,209,192,23,61550,4,3,3,10,Silver
206,210,60,12,22148,3,4,4,11,Bronze
207,211,25,1,66584,2,4,3,9,Silver
208,212,81,15,32404,3,4,4,11,Bronze
209,214,61,101,221218,3,1,1,5,Platinum
210,215,79,57,128931,3,2,2,7,Gold
211,216,24,102,225048,2,1,1,4,Platinum
212,217,53,65,163374,3,2,2,7,Gold
213,218,75,18,78896,3,3,3,9,Silver
214,219,58,149,390308,3,1,1,5,Platinum
215,220,278,20,35371,4,3,4,11,Bronze
216,221,3,101,273666,1,1,1,3,Platinum
217,222,96,30,76578,3,3,3,9,Silver
218,223,30,42,45614,2,2,3,7,Gold
219,224,22,10,17462,2,4,4,10,Silver
220,225,18,82,465339,1,2,1,4,Platinum
221,226,15,91,192194,1,2,2,5,Platinum
222,227,2,449,1584405,1,1,1,3,Platinum
223,228,233,10,19714,4,4,4,12,Bronze
224,229,277,17,34377,4,4,4,12,Bronze
225,230,107,36,74810,3,3,3,9,Silver
226,231,212,84,312048,4,2,1,7,Gold
227,232,24,285,766691,2,1,1,4,Platinum
228,233,11,224,547037,1,1,1,3,Platinum
229,234,5,38,94297,1,3,2,6,Gold
230,235,10,62,133115,1,2,2,5,Platinum
231,236,58,30,59362,3,3,3,9,Silver
232,237,59,97,255699,3,2,1,6,Gold
233,238,90,99,207962,3,2,2,7,Gold
234,239,68,387,745760,3,1,1,5,Platinum
235,240,34,38,83074,2,3,3,8,Gold
236,241,239,21,45669,4,3,3,10,Silver
237,242,25,50,111655,2,2,2,6,Gold
238,243,116,9,17803,3,4,4,11,Bronze
239,244,27,44,117382,2,2,2,6,Gold
240,245,130,17,291394,3,4,1,8,Gold
241,246,130,31,67129,3,3,3,9,Silver
242,247,34,69,212202,2,2,1,5,Platinum
243,248,5,45,182772,1,2,2,5,Platinum
244,249,23,110,394423,2,1,1,4,Platinum
245,250,155,20,35705,4,3,4,11,Bronze
246,251,108,29,80028,3,3,3,9,Silver
247,252,4,19,35984,1,3,4,8,Gold
248,253,336,9,16065,4,4,4,12,Bronze
249,254,332,47,101474,4,2,2,8,Gold
250,255,149,43,266350,4,2,1,7,Gold
251,256,13,34,65543,1,3,3,7,Gold
252,257,19,121,451870,1,1,1,3,Platinum
253,258,12,44,188592,1,2,2,5,Platinum
254,259,19,35,77407,1,3,3,7,Gold
255,260,31,4,11160,2,4,4,10,Silver
256,261,13,12,30294,1,4,4,9,Silver
257,262,1,220,458759,1,1,1,3,Platinum
258,263,10,28,511104,1,3,1,5,Platinum
259,264,333,2,6252,4,4,4,12,Bronze
260,266,59,32,70122,3,3,3,9,Silver
261,267,12,157,393219,1,1,1,3,Platinum
262,268,151,98,200790,4,2,2,8,Gold
263,269,11,87,350458,1,2,1,4,Platinum
264,270,331,10,26968,4,4,4,12,Bronze
265,271,6,41,76200,1,3,3,7,Gold
266,272,40,79,245256,2,2,1,5,Platinum
267,273,26,39,147640,2,3,2,7,Gold
268,274,43,156,2011928,2,1,1,4,Platinum
269,275,60,44,123406,3,2,2,7,Gold
270,276,1,49,97967,1,2,2,5,Platinum
271,277,16,616,1608655,1,1,1,3,Platinum
272,278,4,496,1396584,1,1,1,3,Platinum
273,279,5,331,1000877,1,1,1,3,Platinum
274,280,11,98,323115,1,2,1,4,Platinum
275,281,29,151,329227,2,1,1,4,Platinum
276,282,375,6,11570,4,4,4,12,Bronze
277,283,114,171,631238,3,1,1,5,Platinum
278,284,26,70,148131,2,2,2,6,Gold
279,285,206,15,39598,4,4,3,11,Bronze
280,286,36,27,114558,2,3,2,7,Gold
281,287,128,35,83193,3,3,3,9,Silver
282,288,71,35,103693,3,3,2,8,Gold
283,289,9,27,69255,1,3,3,7,Gold
284,290,29,38,101799,2,3,2,7,Gold
285,291,8,264,614008,1,1,1,3,Platinum
286,292,80,51,100749,3,2,2,7,Gold
287,293,20,11,23052,2,4,4,10,Silver
288,294,72,20,33674,3,3,4,10,Silver
289,295,9,81,235070,1,2,1,4,Platinum
290,296,16,328,847355,1,1,1,3,Platinum
291,297,292,33,72796,4,3,3,10,Silver
292,298,33,147,305092,2,1,1,4,Platinum
293,299,16,203,1149304,1,1,1,3,Platinum
294,300,97,74,146330,3,2,2,7,Gold
295,301,29,120,440270,2,1,1,4,Platinum
296,302,1,37,106928,1,3,2,6,Gold
297,303,10,254,575673,1,1,1,3,Platinum
298,304,107,20,37608,3,3,4,10,Silver
299,305,4,67,131467,1,2,2,5,Platinum
300,306,152,53,110145,4,2,2,8,Gold
301,307,72,18,32715,3,3,4,10,Silver
302,308,6,37,76914,1,3,3,7,Gold
303,309,3,342,747446,1,1,1,3,Platinum
304,310,32,155,335926,2,1,1,4,Platinum
305,311,90,52,129420,3,2,2,7,Gold
306,312,4,68,91023,1,2,2,5,Platinum
307,313,7,49,115089,1,2,2,5,Platinum
308,314,372,23,43142,4,3,3,10,Silver
309,315,29,117,390149,2,1,1,4,Platinum
310,316,11,132,443366,1,1,1,3,Platinum
311,317,72,42,91772,3,2,2,7,Gold
312,318,114,25,55630,3,3,3,9,Silver
313,319,24,273,2308964,2,1,1,4,Platinum
314,320,180,11,26680,4,4,4,12,Bronze
315,321,235,22,43360,4,3,3,10,Silver
316,322,356,4,17596,4,4,4,12,Bronze
317,323,317,41,87299,4,3,2,9,Silver
318,324,333,3,24024,4,4,4,12,Bronze
319,325,373,10,21355,4,4,4,12,Bronze
320,326,100,37,122634,3,3,2,8,Gold
321,327,64,27,62408,3,3,3,9,Silver
322,328,135,134,67823,3,1,3,7,Gold
323,329,57,215,1189651,3,1,1,5,Platinum
324,330,3,103,479956,1,1,1,3,Platinum
325,331,1,4580,4466106,1,1,1,3,Platinum
326,332,4,199,492592,1,1,1,3,Platinum
327,333,129,15,33848,3,4,4,11,Bronze
328,334,82,53,561920,3,2,1,6,Gold
329,335,23,197,2709712,2,1,1,4,Platinum
330,336,236,63,613410,4,2,1,7,Gold
331,337,282,3,1956,4,4,4,12,Bronze
332,338,87,4,21072,3,4,4,11,Bronze
333,339,16,365,551253,1,1,1,3,Platinum
334,340,117,97,375967,3,2,1,6,Gold
335,341,53,92,178480,3,2,2,7,Gold
336,342,8,67,226818,1,2,1,4,Platinum
337,343,141,18,62484,3,3,3,9,Silver
338,344,317,45,186675,4,2,2,8,Gold
339,345,4,306,822597,1,1,1,3,Platinum
340,346,239,32,132446,4,3,2,9,Silver
341,347,212,12,178814,4,4,2,10,Silver
342,348,60,54,103103,3,2,2,7,Gold
343,349,19,61,170308,1,2,2,5,Platinum
344,350,20,44,117303,2,2,2,6,Gold
345,351,38,149,494826,2,1,1,4,Platinum
346,352,64,24,103856,3,3,2,8,Gold
347,353,5,98,242916,1,2,1,4,Platinum
348,354,3,78,161072,1,2,2,5,Platinum
349,355,16,58,67068,1,2,3,6,Gold
350,356,365,13,31331,4,4,4,12,Bronze
351,357,12,17,57822,1,4,3,8,Gold
352,358,69,3,7771,3,4,4,11,Bronze
353,359,193,20,38140,4,3,4,11,Bronze
354,360,375,1,27360,4,4,4,12,Bronze
355,361,257,24,45942,4,3,3,10,Silver
356,362,335,22,63051,4,3,3,10,Silver
357,363,54,45,116840,3,2,2,7,Gold
358,364,19,13,34491,1,4,4,9,Silver
359,365,369,12,27371,4,4,4,12,Bronze
360,366,173,6,267792,4,4,1,9,Silver
361,367,187,24,53246,4,3,3,10,Silver
362,368,40,27,55433,2,3,3,8,Gold
363,369,178,24,49030,4,3,3,10,Silver
364,370,263,28,57589,4,3,3,10,Silver
365,371,45,15,32596,2,4,4,10,Silver
366,372,103,1,11952,3,4,4,11,Bronze
367,373,149,45,106741,4,2,2,8,Gold
368,374,96,27,51582,3,3,3,9,Silver
369,375,284,3,15336,4,4,4,12,Bronze
370,376,262,13,149350,4,4,2,10,Silver
371,377,4,59,130678,1,2,2,5,Platinum
372,378,216,6,12198,4,4,4,12,Bronze
373,379,72,46,124896,3,2,2,7,Gold
374,380,80,5,187830,3,4,2,9,Silver
375,381,60,25,51028,3,3,3,9,Silver
376,382,3,91,195875,1,2,2,5,Platinum
377,383,9,25,56419,1,3,3,7,Gold
378,384,6,56,125062,1,2,2,5,Platinum
379,385,337,11,51269,4,4,3,11,Bronze
380,386,40,36,1028696,2,3,1,6,Gold
381,387,263,9,28791,4,4,4,12,Bronze
382,388,33,27,48021,2,3,3,8,Gold
383,389,146,24,49573,4,3,3,10,Silver
384,390,283,18,37240,4,3,4,11,Bronze
385,391,60,175,315762,3,1,1,5,Platinum
386,392,174,12,14774,4,4,4,12,Bronze
387,393,34,123,86503,2,1,2,5,Platinum
388,394,3,314,752717,1,1,1,3,Platinum
389,395,144,113,352477,4,1,1,6,Gold
390,396,5,420,548440,1,1,1,3,Platinum
391,397,71,34,140634,3,3,2,8,Gold
392,398,74,103,208013,3,1,2,6,Gold
393,399,30,52,39466,2,2,3,7,Gold
394,400,271,27,43628,4,3,3,10,Silver
395,401,23,91,127997,2,2,2,6,Gold
396,402,32,49,134920,2,2,2,6,Gold
397,403,97,50,18150,3,2,4,9,Silver
398,404,295,17,39266,4,4,4,12,Bronze
399,405,135,78,233792,3,2,1,6,Gold
400,406,80,110,163559,3,1,2,6,Gold
401,407,373,3,4728,4,4,4,12,Bronze
402,408,8,314,277211,1,1,1,3,Platinum
403,409,211,46,123904,4,2,2,8,Gold
404,410,54,5,61048,3,4,3,10,Silver
405,411,140,3,31152,3,4,4,11,Bronze
406,412,27,95,206761,2,2,2,6,Gold
407,413,284,25,59304,4,3,3,10,Silver
408,414,27,538,630043,2,1,1,4,Platinum
409,415,186,107,208612,4,1,2,7,Gold
410,417,85,11,44518,3,4,3,10,Silver
411,418,327,66,73421,4,2,3,9,Silver
412,419,283,4,44744,4,4,3,11,Bronze
413,420,150,1,30846,4,4,4,12,Bronze
414,421,58,83,308777,3,2,1,6,Gold
415,422,4,154,214162,1,1,1,3,Platinum
416,423,237,47,115511,4,2,2,8,Gold
417,424,47,10,72222,2,4,3,9,Silver
418,425,276,7,30694,4,4,4,12,Bronze
419,426,10,13,156624,1,4,2,7,Gold
420,427,25,42,78180,2,2,3,7,Gold
421,428,89,7,32195,3,4,4,11,Bronze
422,429,64,71,154990,3,2,2,7,Gold
423,430,68,82,176674,3,2,2,7,Gold
424,431,220,5,39880,4,4,3,11,Bronze
425,432,25,82,49953,2,2,3,7,Gold
426,433,191,3,76050,4,4,3,11,Bronze
427,434,31,34,23974,2,3,4,9,Silver
428,435,45,22,48139,2,3,3,8,Gold
429,436,205,4,27084,4,4,4,12,Bronze
430,437,14,107,1296156,1,1,1,3,Platinum
431,438,267,10,17244,4,4,4,12,Bronze
432,439,19,72,67161,1,2,3,6,Gold
433,440,12,63,373610,1,2,1,4,Platinum
434,441,185,2,132600,4,4,2,10,Silver
435,442,40,91,284709,2,2,1,5,Platinum
436,443,25,75,393252,2,2,1,5,Platinum
437,444,7,24,197798,1,3,2,6,Gold
438,445,5,50,314931,1,2,1,4,Platinum
439,446,149,22,39997,4,3,3,10,Silver
440,447,139,107,354411,3,1,1,5,Platinum
441,448,131,2,68520,3,4,3,10,Silver
442,449,10,50,168147,1,2,2,5,Platinum
443,450,18,28,23752,1,3,4,8,Gold
444,451,10,720,2133743,1,1,1,3,Platinum
445,452,162,28,53858,4,3,3,10,Silver
446,453,65,28,20657,3,3,4,10,Silver
447,454,89,29,113428,3,3,2,8,Gold
448,455,5,45,90726,1,2,2,5,Platinum
449,456,37,84,297164,2,2,1,5,Platinum
450,457,312,8,13523,4,4,4,12,Bronze
451,458,79,25,55359,3,3,3,9,Silver
452,459,22,69,3224042,2,2,1,5,Platinum
453,460,25,106,83101,2,1,3,6,Gold
454,461,3,129,307571,1,1,1,3,Platinum
455,462,18,62,141502,1,2,2,5,Platinum
456,463,16,120,200553,1,1,2,4,Platinum
457,464,27,9,19458,2,4,4,10,Silver
458,465,66,47,1406976,3,2,1,6,Gold
459,466,55,99,109997,3,2,2,7,Gold
460,467,132,75,77673,3,2,3,8,Gold
461,469,36,30,73898,2,3,3,8,Gold
462,470,289,23,56428,4,3,3,10,Silver
463,471,145,97,218908,4,2,1,7,Gold
464,472,17,116,267713,1,1,1,3,Platinum
465,473,31,215,543889,2,1,1,4,Platinum
466,474,3,23,235382,1,3,1,5,Platinum
467,475,10,63,129620,1,2,2,5,Platinum
468,476,6,79,171197,1,2,2,5,Platinum
469,477,10,17,38045,1,4,4,9,Silver
470,478,2,180,666300,1,1,1,3,Platinum
471,479,307,19,12774,4,3,4,11,Bronze
472,480,10,238,520996,1,1,1,3,Platinum
473,481,8,16,34125,1,4,4,9,Silver
474,482,9,95,231113,1,2,1,4,Platinum
475,483,90,109,94209,3,1,2,6,Gold
476,484,11,10,19526,1,4,4,9,Silver
477,485,364,19,192206,4,3,2,9,Silver
478,486,113,5,17062,3,4,4,11,Bronze
479,487,8,151,60410,1,1,3,5,Platinum
480,488,5,305,1610541,1,1,1,3,Platinum
481,489,198,8,15351,4,4,4,12,Bronze
482,490,212,22,106980,4,3,2,9,Silver
483,491,158,9,4438,4,4,4,12,Bronze
484,492,165,20,772662,4,3,1,8,Gold
485,493,30,20,52852,2,3,3,8,Gold
486,494,243,28,52752,4,3,3,10,Silver
487,495,21,4,10454,2,4,4,10,Silver
488,496,1,76,220970,1,2,1,4,Platinum
489,497,74,28,70316,3,3,3,9,Silver
490,498,293,92,60365,4,2,3,9,Silver
491,499,6,63,696022,1,2,1,4,Platinum
492,500,35,13,48380,2,4,3,9,Silver
493,501,24,31,70444,2,3,3,8,Gold
494,502,25,27,53197,2,3,3,8,Gold
495,503,5,61,118755,1,2,2,5,Platinum
496,504,89,3,27288,3,4,4,11,Bronze
497,505,23,59,156353,2,2,2,6,Gold
498,506,197,28,63967,4,3,3,10,Silver
499,507,109,31,69528,3,3,3,9,Silver
500,508,6,339,1300739,1,1,1,3,Platinum
501,509,320,7,16994,4,4,4,12,Bronze
502,510,109,6,19676,3,4,4,11,Bronze
503,511,12,404,800183,1,1,1,3,Platinum
504,512,174,26,60476,4,3,3,10,Silver
505,513,57,4,10097,3,4,4,11,Bronze
506,514,324,14,32853,4,4,4,12,Bronze
507,515,375,3,5701,4,4,4,12,Bronze
508,516,10,89,212994,1,2,1,4,Platinum
509,517,3,219,581263,1,1,1,3,Platinum
510,518,11,110,394009,1,1,1,3,Platinum
511,519,54,176,425084,3,1,1,5,Platinum
512,520,74,47,105968,3,2,2,7,Gold
513,521,10,1,23040,1,4,4,9,Silver
514,522,18,458,1009377,1,1,1,3,Platinum
515,523,5,131,337026,1,1,1,3,Platinum
516,524,65,38,70742,3,3,3,9,Silver
517,525,2,40,185880,1,3,2,6,Gold
518,526,119,19,834000,3,3,1,7,Gold
519,527,23,45,104796,2,2,2,6,Gold
520,528,35,10,132814,2,4,2,8,Gold
521,529,12,99,100562,1,2,2,5,Platinum
522,530,53,71,118006,3,2,2,7,Gold
523,531,358,11,24175,4,4,4,12,Bronze
524,532,55,37,82142,3,3,3,9,Silver
525,533,74,27,128518,3,3,2,8,Gold
526,534,139,48,109939,3,2,2,7,Gold
527,535,81,28,108902,3,3,2,8,Gold
528,536,9,43,88356,1,2,2,5,Platinum
529,537,276,13,67660,4,4,3,11,Bronze
530,538,292,33,75834,4,3,3,10,Silver
531,539,100,18,41435,3,3,3,9,Silver
532,540,31,35,75897,2,3,3,8,Gold
533,541,57,171,402445,3,1,1,5,Platinum
534,542,16,136,247682,1,1,1,3,Platinum
535,543,67,14,82962,3,4,3,10,Silver
536,544,15,402,773970,1,1,1,3,Platinum
537,545,213,18,46836,4,3,3,10,Silver
538,546,79,76,168041,3,2,2,7,Gold
539,547,29,8,29432,2,4,4,10,Silver
540,548,250,8,20052,4,4,4,12,Bronze
541,549,255,15,35544,4,4,4,12,Bronze
542,550,73,10,29825,3,4,4,11,Bronze
543,551,192,11,43666,4,4,3,11,Bronze
544,552,13,69,134493,1,2,2,5,Platinum
545,553,374,14,23751,4,4,4,12,Bronze
546,554,25,48,64095,2,2,3,7,Gold
547,555,83,15,13569,3,4,4,11,Bronze
548,556,13,2,48200,1,4,3,8,Gold
549,557,1,425,681332,1,1,1,3,Platinum
550,558,194,9,29490,4,4,4,12,Bronze
551,559,268,7,20586,4,4,4,12,Bronze
552,560,130,22,111700,3,3,2,8,Gold
553,561,2,112,106117,1,1,2,4,Platinum
554,562,4,358,1520127,1,1,1,3,Platinum
555,563,8,6,25582,1,4,4,9,Silver
556,564,183,6,12288,4,4,4,12,Bronze
557,565,12,1028,3822541,1,1,1,3,Platinum
558,566,129,72,484681,3,2,1,6,Gold
559,567,6,18,40408,1,3,3,7,Gold
560,568,158,22,50639,4,3,3,10,Silver
561,569,5,1818,7480449,1,1,1,3,Platinum
562,570,10,154,1004918,1,1,1,3,Platinum
563,571,29,21,56354,2,3,3,8,Gold
564,572,71,25,59507,3,3,3,9,Silver
565,573,279,159,982668,4,1,1,6,Gold
566,574,27,24,285738,2,3,1,6,Gold
567,575,71,6,16392,3,4,4,11,Bronze
568,576,33,423,726857,2,1,1,4,Platinum
569,577,2,572,3679515,1,1,1,3,Platinum
570,578,108,1,39456,3,4,3,10,Silver
571,579,239,8,16092,4,4,4,12,Bronze
572,580,5,304,852787,1,1,1,3,Platinum
573,581,41,8,29308,2,4,4,10,Silver
574,582,6,20,136536,1,3,2,6,Gold
575,583,135,1,9216,3,4,4,11,Bronze
576,584,47,58,216469,2,2,1,5,Platinum
577,585,373,10,52288,4,4,3,11,Bronze
578,586,60,47,104402,3,2,2,7,Gold
579,587,33,145,168187,2,1,2,5,Platinum
580,588,1,200,1192888,1,1,1,3,Platinum
581,589,12,120,313154,1,1,1,3,Platinum
582,590,140,30,61584,3,3,3,9,Silver
583,591,24,76,143247,2,2,2,6,Gold
584,592,20,79,136583,2,2,2,6,Gold
585,593,246,1,4212,4,4,4,12,Bronze
586,594,270,50,39881,4,2,3,9,Silver
587,595,103,55,122263,3,2,2,7,Gold
588,596,90,235,490319,3,1,1,5,Platinum
589,597,5,140,318879,1,1,1,3,Platinum
590,598,78,15,32308,3,4,4,11,Bronze
591,599,98,2,8280,3,4,4,11,Bronze
592,600,25,44,135149,2,2,2,6,Gold
593,601,268,3,9126,4,4,4,12,Bronze
594,602,275,7,12965,4,4,4,12,Bronze
595,603,86,98,229623,3,2,1,6,Gold
596,605,58,127,321521,3,1,1,5,Platinum
597,606,11,704,481153,1,1,1,3,Platinum
598,607,24,63,124103,2,2,2,6,Gold
599,608,19,170,627281,1,1,1,3,Platinum
600,609,109,46,52298,3,2,3,8,Gold
601,610,85,135,314859,3,1,1,5,Platinum
602,611,20,23,41122,2,3,3,8,Gold
603,612,333,3,12651,4,4,4,12,Bronze
604,613,46,6,69154,2,4,3,9,Silver
605,614,27,17,32337,2,4,4,10,Silver
606,615,12,4,74760,1,4,3,8,Gold
607,616,30,319,467213,2,1,1,4,Platinum
608,617,15,86,235562,1,2,1,4,Platinum
609,618,296,74,147084,4,2,2,8,Gold
610,619,7,15,69282,1,4,3,8,Gold
611,621,37,85,122707,2,2,2,6,Gold
612,622,50,87,252700,2,2,1,5,Platinum
613,623,95,79,155801,3,2,2,7,Gold
614,624,9,121,200102,1,1,2,4,Platinum
615,625,24,4,11140,2,4,4,10,Silver
616,626,314,8,12868,4,4,4,12,Bronze
617,627,123,79,254608,3,2,1,6,Gold
618,628,47,42,170950,2,2,2,6,Gold
619,629,284,41,52235,4,3,3,10,Silver
620,630,19,64,123152,1,2,2,5,Platinum
621,631,38,131,166024,2,1,2,5,Platinum
622,632,66,13,84480,3,4,3,10,Silver
623,633,27,32,19853,2,3,4,9,Silver
624,634,22,46,57669,2,2,3,7,Gold
625,635,5,43,47669,1,2,3,6,Gold
626,636,17,313,357322,1,1,1,3,Platinum
627,637,47,72,74846,2,2,3,7,Gold
628,638,65,17,32082,3,4,4,11,Bronze
629,639,27,265,765330,2,1,1,4,Platinum
630,640,46,11,24002,2,4,4,10,Silver
631,641,10,94,499138,1,2,1,4,Platinum
632,642,15,180,245032,1,1,1,3,Platinum
633,643,271,1,7248,4,4,4,12,Bronze
634,644,40,79,201292,2,2,2,6,Gold
635,645,338,37,26919,4,3,4,11,Bronze
636,646,14,2,12186,1,4,4,9,Silver
637,647,19,29,61660,1,3,3,7,Gold
638,648,96,63,126061,3,2,2,7,Gold
639,649,62,29,14015,3,3,4,10,Silver
640,650,142,3,8028,3,4,4,11,Bronze
641,651,13,110,239038,1,1,1,3,Platinum
642,652,11,226,471808,1,1,1,3,Platinum
643,653,6,118,1321448,1,1,1,3,Platinum
644,654,24,46,113940,2,2,2,6,Gold
645,655,11,57,128322,1,2,2,5,Platinum
646,656,16,8,34464,1,4,4,9,Silver
647,657,60,147,159020,3,1,2,6,Gold
648,658,31,321,789054,2,1,1,4,Platinum
649,659,94,22,47372,3,3,3,9,Silver
650,660,11,56,164951,1,2,2,5,Platinum
651,661,20,142,94774,2,1,2,5,Platinum
652,662,57,90,228883,3,2,1,6,Gold
653,663,272,5,46468,4,4,3,11,Bronze
654,664,132,4,66686,3,4,3,10,Silver
655,665,129,5,10088,3,4,4,11,Bronze
656,666,80,21,89601,3,3,2,8,Gold
657,667,241,65,95565,4,2,2,8,Gold
658,668,201,5,21256,4,4,4,12,Bronze
659,669,61,107,286559,3,1,1,5,Platinum
660,670,4,32,805712,1,3,1,5,Platinum
661,671,274,16,13306,4,4,4,12,Bronze
662,672,202,9,31091,4,4,4,12,Bronze
663,673,84,2,43800,3,4,3,10,Silver
664,674,226,10,19720,4,4,4,12,Bronze
665,675,5,611,363417,1,1,1,3,Platinum
666,676,13,206,167592,1,1,2,4,Platinum
667,677,76,43,107940,3,2,2,7,Gold
668,678,213,58,126192,4,2,2,8,Gold
669,679,26,36,95040,2,3,2,7,Gold
670,680,22,31,79210,2,3,3,8,Gold
671,681,262,22,49778,4,3,3,10,Silver
672,682,97,66,81157,3,2,3,8,Gold
673,683,114,13,34020,3,4,4,11,Bronze
674,684,204,58,73521,4,2,3,9,Silver
675,685,93,27,13856,3,3,4,10,Silver
676,686,51,16,47933,2,4,3,9,Silver
677,687,19,141,282471,1,1,1,3,Platinum
678,688,23,25,68532,2,3,3,8,Gold
679,689,127,26,58820,3,3,3,9,Silver
680,690,94,23,102696,3,3,2,8,Gold
681,691,157,36,189436,4,3,2,9,Silver
682,692,10,13,50530,1,4,3,8,Gold
683,694,12,38,84236,1,3,3,7,Gold
684,695,62,87,35487,3,2,4,9,Silver
685,696,62,8,64478,3,4,3,10,Silver
686,697,269,9,106684,4,4,2,10,Silver
687,698,264,11,25323,4,4,4,12,Bronze
688,699,2,1673,990656,1,1,1,3,Platinum
689,700,54,91,290524,3,2,1,6,Gold
690,701,12,187,615524,1,1,1,3,Platinum
691,702,3,211,551862,1,1,1,3,Platinum
692,703,18,439,512966,1,1,1,3,Platinum
693,704,4,316,716994,1,1,1,3,Platinum
694,705,372,1,59200,4,4,3,11,Bronze
695,706,38,96,34150,2,2,4,8,Gold
696,707,34,15,30719,2,4,4,10,Silver
697,708,114,16,19557,3,4,4,11,Bronze
698,709,65,30,66685,3,3,3,9,Silver
699,710,20,8,33994,2,4,4,10,Silver
700,711,41,46,79793,2,2,3,7,Gold
701,712,80,9,16870,3,4,4,11,Bronze
702,713,123,85,108465,3,2,2,7,Gold
703,714,19,37,127700,1,3,2,6,Gold
704,715,60,7,13802,3,4,4,11,Bronze
705,716,331,13,25128,4,4,4,12,Bronze
706,717,24,187,375667,2,1,1,4,Platinum
707,718,156,42,47935,4,2,3,9,Silver
708,719,39,31,72750,2,3,3,8,Gold
709,720,190,54,112077,4,2,2,8,Gold
710,721,362,10,23126,4,4,4,12,Bronze
711,722,141,5,12246,3,4,4,11,Bronze
712,723,8,59,256847,1,2,1,4,Platinum
713,724,3,2,38352,1,4,4,9,Silver
714,725,270,5,15960,4,4,4,12,Bronze
715,726,170,20,48101,4,3,3,10,Silver
716,727,105,80,77434,3,2,3,8,Gold
717,728,162,1,6745,4,4,4,12,Bronze
718,729,352,21,41429,4,3,3,10,Silver
719,730,5,81,261766,1,2,1,4,Platinum
720,731,130,1,1800,3,4,4,11,Bronze
721,732,23,54,167779,2,2,2,6,Gold
722,733,8,107,224304,1,1,1,3,Platinum
723,734,29,72,138802,2,2,2,6,Gold
724,735,6,26,75785,1,3,3,7,Gold
725,736,23,78,199013,2,2,2,6,Gold
726,737,2,62,109778,1,2,2,5,Platinum
727,738,38,86,762070,2,2,1,5,Platinum
728,739,67,124,275939,3,1,1,5,Platinum
729,740,4,20,79626,1,3,3,7,Gold
730,741,6,476,1318676,1,1,1,3,Platinum
731,742,79,106,211099,3,1,1,5,Platinum
732,743,78,11,80554,3,4,3,10,Silver
733,744,18,25,24036,1,3,4,8,Gold
734,745,4,21,86097,1,3,3,7,Gold
735,746,39,75,937126,2,2,1,5,Platinum
736,747,83,12,79199,3,4,3,10,Silver
737,748,39,108,439215,2,1,1,4,Platinum
738,749,318,17,167132,4,4,2,10,Silver
739,750,32,17,102983,2,4,2,8,Gold
740,751,93,53,147831,3,2,2,7,Gold
741,752,15,21,44904,1,3,3,7,Gold
742,753,83,268,444059,3,1,1,5,Platinum
743,754,78,51,109009,3,2,2,7,Gold
744,755,158,19,58235,4,3,3,10,Silver
745,756,201,54,102117,4,2,2,8,Gold
746,757,46,134,1312740,2,1,1,4,Platinum
747,758,261,42,94336,4,2,2,8,Gold
748,759,178,19,44053,4,3,3,10,Silver
749,760,68,119,305114,3,1,1,5,Platinum
750,761,288,20,46268,4,3,3,10,Silver
751,762,72,8,43908,3,4,3,10,Silver
752,763,67,14,30222,3,4,4,11,Bronze
753,764,11,16,34641,1,4,4,9,Silver
754,765,17,40,112326,1,3,2,6,Gold
755,766,67,16,43739,3,4,3,10,Silver
756,767,61,24,56354,3,3,3,9,Silver
757,768,72,51,101099,3,2,2,7,Gold
758,769,123,32,81014,3,3,3,9,Silver
759,770,81,42,96965,3,2,2,7,Gold
760,771,258,90,75669,4,2,3,9,Silver
761,772,269,29,57472,4,3,3,10,Silver
762,773,64,23,51525,3,3,3,9,Silver
763,774,10,166,379051,1,1,1,3,Platinum
764,775,18,60,133168,1,2,2,5,Platinum
765,776,72,10,17035,3,4,4,11,Bronze
766,777,34,128,281957,2,1,1,4,Platinum
767,778,52,1,19584,2,4,4,10,Silver
768,779,258,29,76299,4,3,3,10,Silver
769,780,366,14,39044,4,4,4,12,Bronze
770,781,372,39,92803,4,3,2,9,Silver
771,782,90,23,46523,3,3,3,9,Silver
772,783,61,158,422254,3,1,1,5,Platinum
773,784,89,37,101833,3,3,2,8,Gold
774,785,100,53,123629,3,2,2,7,Gold
775,786,27,97,92116,2,2,2,6,Gold
776,787,32,172,466076,2,1,1,4,Platinum
777,788,281,15,29465,4,4,4,12,Bronze
778,789,31,152,532411,2,1,1,4,Platinum
779,790,330,35,68814,4,3,3,10,Silver
780,791,132,35,81321,3,3,3,9,Silver
781,792,12,51,105251,1,2,2,5,Platinum
782,793,75,13,67356,3,4,3,10,Silver
783,794,204,1,6044,4,4,4,12,Bronze
784,795,2,155,370546,1,1,1,3,Platinum
785,796,186,21,47450,4,3,3,10,Silver
786,797,31,43,165080,2,2,2,6,Gold
787,798,73,38,178256,3,3,2,8,Gold
788,799,193,26,63839,4,3,3,10,Silver
789,800,128,39,86108,3,3,3,9,Silver
790,801,18,3,10860,1,4,4,9,Silver
791,802,6,11,30336,1,4,4,9,Silver
792,803,78,27,66206,3,3,3,9,Silver
793,804,3,478,3646310,1,1,1,3,Platinum
794,805,26,28,122598,2,3,2,7,Gold
795,806,108,18,24307,3,3,4,10,Silver
796,807,134,24,229993,3,3,1,7,Gold
797,808,44,19,76604,2,3,3,8,Gold
798,809,5,28,71264,1,3,3,7,Gold
799,810,12,304,805199,1,1,1,3,Platinum
800,811,65,16,35250,3,4,4,11,Bronze
801,812,151,8,20468,4,4,4,12,Bronze
802,813,41,103,245058,2,1,1,4,Platinum
803,814,65,127,327522,3,1,1,5,Platinum
804,815,109,78,221325,3,2,1,6,Gold
805,816,1,157,471749,1,1,1,3,Platinum
806,817,21,29,97152,2,3,2,7,Gold
807,818,11,74,29371,1,2,4,7,Gold
808,819,11,67,175463,1,2,2,5,Platinum
809,820,19,49,103499,1,2,2,5,Platinum
810,821,68,46,160208,3,2,2,7,Gold
811,822,76,10,69336,3,4,3,10,Silver
812,823,6,101,497434,1,1,1,3,Platinum
813,824,3,12,23428,1,4,4,9,Silver
814,825,16,167,407797,1,1,1,3,Platinum
815,826,256,54,38559,4,2,4,10,Silver
816,827,92,13,38360,3,4,4,11,Bronze
817,828,24,59,143297,2,2,2,6,Gold
818,829,17,195,435968,1,1,1,3,Platinum
819,830,24,19,38759,2,3,4,9,Silver
820,831,29,71,289773,2,2,1,5,Platinum
821,832,27,443,415431,2,1,1,4,Platinum
822,833,269,2,59093,4,4,3,11,Bronze
823,834,166,17,42714,4,4,3,11,Bronze
824,835,25,46,123974,2,2,2,6,Gold
825,836,19,63,215050,1,2,1,4,Platinum
826,837,8,382,1242864,1,1,1,3,Platinum
827,838,30,17,33275,2,4,4,10,Silver
828,839,39,27,202618,2,3,2,7,Gold
829,840,254,9,17798,4,4,4,12,Bronze
830,841,59,41,85845,3,3,3,9,Silver
831,842,185,17,46026,4,4,3,11,Bronze
832,843,11,99,139254,1,2,2,5,Platinum
833,844,3,302,700143,1,1,1,3,Platinum
834,845,101,10,20740,3,4,4,11,Bronze
835,846,4,260,333016,1,1,1,3,Platinum
836,847,62,21,59258,3,3,3,9,Silver
837,848,237,64,30069,4,2,4,10,Silver
838,849,195,86,195048,4,2,2,8,Gold
839,850,179,58,143976,4,2,2,8,Gold
840,851,40,79,195017,2,2,2,6,Gold
841,852,204,15,34265,4,4,4,12,Bronze
842,853,46,109,243268,2,1,1,4,Platinum
843,854,233,11,25433,4,4,4,12,Bronze
844,855,66,10,22148,3,4,4,11,Bronze
845,856,242,8,34390,4,4,4,12,Bronze
846,857,234,23,58653,4,3,3,10,Silver
847,858,79,69,142258,3,2,2,7,Gold
848,859,59,34,76621,3,3,3,9,Silver
849,860,18,422,1127314,1,1,1,3,Platinum
850,861,106,14,65704,3,4,3,10,Silver
851,862,52,86,168444,2,2,2,6,Gold
852,863,137,50,146716,3,2,2,7,Gold
853,864,278,6,67141,4,4,3,11,Bronze
854,865,312,18,39471,4,3,3,10,Silver
855,866,10,48,246492,1,2,1,4,Platinum
856,867,11,35,83831,1,3,3,7,Gold
857,868,283,19,44256,4,3,3,10,Silver
858,869,19,42,183846,1,2,2,5,Platinum
859,870,24,65,146478,2,2,2,6,Gold
860,871,289,52,163803,4,2,2,8,Gold
861,872,18,18,42180,1,3,3,7,Gold
862,873,72,17,32445,3,4,4,11,Bronze
863,874,65,22,38053,3,3,4,10,Silver
864,875,73,211,487340,3,1,1,5,Platinum
865,876,318,26,62509,4,3,3,10,Silver
866,877,4,162,332019,1,1,1,3,Platinum
867,878,245,12,12483,4,4,4,12,Bronze
868,879,9,43,151305,1,2,2,5,Platinum
869,880,2,115,251893,1,1,1,3,Platinum
870,881,261,15,30664,4,4,4,12,Bronze
871,882,127,10,26526,3,4,4,11,Bronze
872,883,75,4,18004,3,4,4,11,Bronze
873,884,73,59,119435,3,2,2,7,Gold
874,885,23,44,193809,2,2,2,6,Gold
875,886,60,141,281865,3,1,1,5,Platinum
876,887,86,38,87576,3,3,2,8,Gold
877,888,81,8,13722,3,4,4,11,Bronze
878,889,59,87,368454,3,2,1,6,Gold
879,890,2,435,148043,1,1,2,4,Platinum
880,891,31,5,14824,2,4,4,10,Silver
881,892,34,172,474106,2,1,1,4,Platinum
882,893,41,27,84999,2,3,3,8,Gold
883,894,15,6,77516,1,4,3,8,Gold
884,895,34,223,319498,2,1,1,4,Platinum
885,896,81,15,34896,3,4,4,11,Bronze
886,897,207,22,56756,4,3,3,10,Silver
887,898,34,66,27056,2,2,4,8,Gold
888,899,183,76,37277,4,2,4,10,Silver
889,900,3,296,729626,1,1,1,3,Platinum
890,901,3,179,447227,1,1,1,3,Platinum
891,902,44,25,136670,2,3,2,7,Gold
892,903,86,37,77980,3,3,3,9,Silver
893,904,40,87,35986,2,2,4,8,Gold
894,905,13,98,80303,1,2,3,6,Gold
895,906,97,124,92920,3,1,2,6,Gold
896,907,28,51,112564,2,2,2,6,Gold
897,908,320,4,9795,4,4,4,12,Bronze
898,909,67,109,444235,3,1,1,5,Platinum
899,910,74,136,557387,3,1,1,5,Platinum
900,911,29,34,87105,2,3,2,7,Gold
901,912,6,175,80312,1,1,3,5,Platinum
902,913,8,33,20514,1,3,4,8,Gold
903,914,216,14,20097,4,4,4,12,Bronze
904,915,82,82,223467,3,2,1,6,Gold
905,916,85,49,88330,3,2,2,7,Gold
906,917,355,82,154749,4,2,2,8,Gold
907,918,20,38,31788,2,3,4,9,Silver
908,919,41,176,114732,2,1,2,5,Platinum
909,920,174,44,23149,4,2,4,10,Silver
910,921,18,84,44882,1,2,3,6,Gold
911,922,245,27,32256,4,3,4,11,Bronze
912,923,13,341,301260,1,1,1,3,Platinum
913,924,206,33,166045,4,3,2,9,Silver
914,925,52,26,37730,2,3,4,9,Silver
915,926,25,46,100339,2,2,2,6,Gold
916,927,12,126,818591,1,1,1,3,Platinum
917,928,26,83,207364,2,2,2,6,Gold
918,929,15,23,55581,1,3,3,7,Gold
919,930,311,10,12830,4,4,4,12,Bronze
920,931,156,53,118173,4,2,2,8,Gold
921,932,307,24,16574,4,3,4,11,Bronze
922,933,64,8,85048,3,4,3,10,Silver
923,934,16,174,373642,1,1,1,3,Platinum
924,935,15,21,42546,1,3,3,7,Gold
925,936,12,87,287765,1,2,1,4,Platinum
926,937,65,58,137007,3,2,2,7,Gold
927,938,43,16,28848,2,4,4,10,Silver
928,939,109,128,249424,3,1,1,5,Platinum
929,940,53,26,55811,3,3,3,9,Silver
930,941,6,166,89523,1,1,2,4,Platinum
931,942,48,40,21692,2,3,4,9,Silver
932,943,4,247,685595,1,1,1,3,Platinum
933,944,313,19,36152,4,3,4,11,Bronze
934,945,46,99,98032,2,2,2,6,Gold
935,946,65,23,54495,3,3,3,9,Silver
936,947,27,27,24371,2,3,4,9,Silver
937,948,30,43,39255,2,2,4,8,Gold
938,949,41,98,80295,2,2,3,7,Gold
939,950,13,226,138266,1,1,2,4,Platinum
940,951,90,74,158796,3,2,2,7,Gold
941,952,25,201,185589,2,1,2,5,Platinum
942,953,319,23,50906,4,3,3,10,Silver
943,954,41,44,69579,2,2,3,7,Gold
944,955,175,13,31318,4,4,4,12,Bronze
945,956,117,19,39003,3,3,4,10,Silver
946,957,31,81,86193,2,2,2,6,Gold
947,958,253,19,36916,4,3,4,11,Bronze
948,959,60,92,228164,3,2,1,6,Gold
949,960,29,59,982153,2,2,1,5,Platinum
950,961,6,71,277643,1,2,1,4,Platinum
951,962,102,10,242100,3,4,1,8,Gold
952,963,25,146,260435,2,1,1,4,Platinum
953,964,34,188,196569,2,1,2,5,Platinum
954,965,68,62,140524,3,2,2,7,Gold
955,966,37,63,125880,2,2,2,6,Gold
956,967,53,100,101468,3,2,2,7,Gold
957,968,17,8,18081,1,4,4,9,Silver
958,969,75,40,144944,3,3,2,8,Gold
959,970,216,66,44292,4,2,3,9,Silver
960,971,33,28,64182,2,3,3,8,Gold
961,972,18,146,362366,1,1,1,3,Platinum
962,973,121,5,35050,3,4,4,11,Bronze
963,974,11,79,217747,1,2,1,4,Platinum
964,975,257,23,41181,4,3,3,10,Silver
965,976,17,96,224510,1,2,1,4,Platinum
966,977,42,6,10773,2,4,4,10,Silver
967,978,46,63,137507,2,2,2,6,Gold
968,979,44,166,380221,2,1,1,4,Platinum
969,980,115,56,125963,3,2,2,7,Gold
970,981,165,49,64870,4,2,3,9,Silver
971,982,12,16,45773,1,4,3,8,Gold
972,983,10,108,317383,1,1,1,3,Platinum
973,984,206,104,208096,4,1,2,7,Gold
974,985,86,53,115390,3,2,2,7,Gold
975,986,180,13,23450,4,4,4,12,Bronze
976,987,61,12,10361,3,4,4,11,Bronze
977,988,150,87,38604,4,2,4,10,Silver
978,989,3,470,833904,1,1,1,3,Platinum
979,990,51,9,32918,2,4,4,10,Silver
980,991,76,25,49196,3,3,3,9,Silver
981,992,303,6,22267,4,4,4,12,Bronze
982,993,19,65,46210,1,2,3,6,Gold
983,994,152,25,64644,4,3,3,10,Silver
984,995,152,16,68568,4,4,3,11,Bronze
985,996,2,195,476752,1,1,1,3,Platinum
986,997,18,57,102345,1,2,2,5,Platinum
987,998,191,3,6302,4,4,4,12,Bronze
988,999,286,30,8985,4,3,4,11,Bronze
989,1000,4,37,263771,1,3,1,5,Platinum
990,1001,183,8,10575,4,4,4,12,Bronze
991,1002,64,6,111008,3,4,2,9,Silver
992,1003,61,9,19737,3,4,4,11,Bronze
993,1004,25,53,210525,2,2,2,6,Gold
994,1006,5,566,9375795,1,1,1,3,Platinum
995,1007,32,90,329089,2,2,1,5,Platinum
996,1008,39,12,23415,2,4,4,10,Silver
997,1009,156,14,32972,4,4,4,12,Bronze
998,1010,27,197,343530,2,1,1,4,Platinum
999,1011,326,1,10050,4,4,4,12,Bronze
1000,1012,7,134,302460,1,1,1,3,Platinum
1001,1013,8,28,91646,1,3,2,6,Gold
1002,1014,303,20,44267,4,3,3,10,Silver
1003,1015,268,48,98208,4,2,2,8,Gold
1004,1016,272,50,46103,4,2,3,9,Silver
1005,1017,4,336,802348,1,1,1,3,Platinum
1006,1018,35,8,25044,2,4,4,10,Silver
1007,1019,220,13,31803,4,4,4,12,Bronze
1008,1020,247,10,42674,4,4,3,11,Bronze
1009,1021,282,105,138027,4,1,2,7,Gold
1010,1022,270,21,18037,4,3,4,11,Bronze
1011,1023,33,102,234514,2,1,1,4,Platinum
1012,1024,250,12,42935,4,4,3,11,Bronze
1013,1025,17,60,133651,1,2,2,5,Platinum
1014,1026,118,43,101464,3,2,2,7,Gold
1015,1027,37,28,67663,2,3,3,8,Gold
1016,1028,132,85,306710,3,2,1,6,Gold
1017,1029,218,6,22258,4,4,4,12,Bronze
1018,1030,52,104,236123,2,1,1,4,Platinum
1019,1031,39,42,169880,2,2,2,6,Gold
1020,1032,30,20,42231,2,3,3,8,Gold
1021,1033,38,63,124411,2,2,2,6,Gold
1022,1034,136,43,94918,3,2,2,7,Gold
1023,1035,220,38,73505,4,3,3,10,Silver
1024,1036,29,33,71265,2,3,3,8,Gold
1025,1037,25,196,349776,2,1,1,4,Platinum
1026,1038,6,191,99325,1,1,2,4,Platinum
1027,1039,201,30,38331,4,3,4,11,Bronze
1028,1040,23,3,23076,2,4,4,10,Silver
1029,1041,241,23,56822,4,3,3,10,Silver
1030,1042,72,34,76625,3,3,3,9,Silver
1031,1043,17,321,365661,1,1,1,3,Platinum
1032,1044,4,41,253560,1,3,1,5,Platinum
1033,1045,96,72,178646,3,2,2,7,Gold
1034,1046,163,25,54676,4,3,3,10,Silver
1035,1047,381,1,8128,4,4,4,12,Bronze
1036,1048,97,28,113535,3,3,2,8,Gold
1037,1049,55,24,192831,3,3,2,8,Gold
1038,1050,289,9,38231,4,4,4,12,Bronze
1039,1051,126,76,171521,3,2,2,7,Gold
1040,1052,288,35,97703,4,3,2,9,Silver
1041,1053,152,12,35080,4,4,4,12,Bronze
1042,1054,4,342,273036,1,1,1,3,Platinum
1043,1055,3,142,679382,1,1,1,3,Platinum
1044,1056,12,117,408638,1,1,1,3,Platinum
1045,1057,35,25,78531,2,3,3,8,Gold
1046,1058,55,57,37927,3,2,4,9,Silver
1047,1059,51,70,141470,2,2,2,6,Gold
1048,1060,219,7,48304,4,4,3,11,Bronze
1049,1061,64,15,190896,3,4,2,9,Silver
1050,1062,71,207,202046,3,1,2,6,Gold
1051,1063,3,368,2048534,1,1,1,3,Platinum
1052,1064,3,135,340034,1,1,1,3,Platinum
1053,1065,65,119,341345,3,1,1,5,Platinum
1054,1066,34,177,139413,2,1,2,5,Platinum
1055,1067,82,22,45131,3,3,3,9,Silver
1056,1068,1,193,2684902,1,1,1,3,Platinum
1057,1069,106,9,21402,3,4,4,11,Bronze
1058,1070,8,57,48415,1,2,3,6,Gold
1059,1071,251,17,14500,4,4,4,12,Bronze
1060,1072,13,115,107942,1,1,2,4,Platinum
1061,1073,10,31,371170,1,3,1,5,Platinum
1062,1074,368,7,28776,4,4,4,12,Bronze
1063,1075,76,31,49819,3,3,3,9,Silver
1064,1076,5,44,76546,1,2,3,6,Gold
1065,1077,130,11,199700,3,4,2,9,Silver
1066,1078,68,13,24037,3,4,4,11,Bronze
1067,1079,4,349,4901197,1,1,1,3,Platinum
1068,1080,117,39,89832,3,3,2,8,Gold
1069,1081,310,33,72624,4,3,3,10,Silver
1070,1082,67,23,42847,3,3,3,9,Silver
1071,1083,139,60,591556,3,2,1,6,Gold
1072,1084,257,17,35476,4,4,4,12,Bronze
1073,1085,31,137,340085,2,1,1,4,Platinum
1074,1086,55,13,177752,3,4,2,9,Silver
1075,1087,64,10,28848,3,4,4,11,Bronze
1076,1088,368,7,12904,4,4,4,12,Bronze
1077,1089,7,76,213724,1,2,1,4,Platinum
1078,1090,306,12,16826,4,4,4,12,Bronze
1079,1091,29,32,100525,2,3,2,7,Gold
1080,1092,185,10,55611,4,4,3,11,Bronze
1081,1093,44,33,62822,2,3,3,8,Gold
1082,1094,40,65,141461,2,2,2,6,Gold
1083,1095,93,57,203653,3,2,2,7,Gold
1084,1096,24,173,497550,2,1,1,4,Platinum
1085,1097,25,26,64077,2,3,3,8,Gold
1086,1098,31,22,43194,2,3,3,8,Gold
1087,1099,305,36,157544,4,3,2,9,Silver
1088,1100,145,59,46249,4,2,3,9,Silver
1089,1101,7,96,92490,1,2,2,5,Platinum
1090,1102,19,40,120521,1,3,2,6,Gold
1091,1103,33,46,215952,2,2,1,5,Platinum
1092,1104,177,10,24830,4,4,4,12,Bronze
1093,1105,58,93,49218,3,2,3,8,Gold
1094,1106,23,15,32738,2,4,4,10,Silver
1095,1108,20,74,258923,2,2,1,5,Platinum
1096,1109,24,3,6372,2,4,4,10,Silver
1097,1110,160,29,45817,4,3,3,10,Silver
1098,1111,26,55,106296,2,2,2,6,Gold
1099,1112,212,19,37675,4,3,4,11,Bronze
1100,1113,6,174,81863,1,1,3,5,Platinum
1101,1114,254,1,8600,4,4,4,12,Bronze
1102,1115,59,206,430493,3,1,1,5,Platinum
1103,1116,12,20,47496,1,3,3,7,Gold
1104,1117,65,9,38876,3,4,4,11,Bronze
1105,1118,25,55,103752,2,2,2,6,Gold
1106,1119,102,5,232600,3,4,1,8,Gold
1107,1120,52,101,207597,2,1,2,5,Platinum
1108,1121,130,93,201709,3,2,2,7,Gold
1109,1122,99,80,238153,3,2,1,6,Gold
1110,1123,58,23,125850,3,3,2,8,Gold
1111,1124,10,110,932666,1,1,1,3,Platinum
1112,1125,169,14,66430,4,4,3,11,Bronze
1113,1126,58,11,24095,3,4,4,11,Bronze
1114,1127,327,28,26320,4,3,4,11,Bronze
1115,1128,2,76,154694,1,2,2,5,Platinum
1116,1129,20,139,303858,2,1,1,4,Platinum
1117,1130,248,20,39344,4,3,3,10,Silver
1118,1131,59,30,60914,3,3,3,9,Silver
1119,1132,75,7,18261,3,4,4,11,Bronze
1120,1133,32,61,130667,2,2,2,6,Gold
1121,1134,39,32,72383,2,3,3,8,Gold
1122,1135,124,307,396921,3,1,1,5,Platinum
1123,1136,6,115,348970,1,1,1,3,Platinum
1124,1137,23,336,788778,2,1,1,4,Platinum
1125,1138,121,23,45069,3,3,3,9,Silver
1126,1139,359,18,63012,4,3,3,10,Silver
1127,1140,55,104,241264,3,1,1,5,Platinum
1128,1141,66,7,13848,3,4,4,11,Bronze
1129,1142,89,3,18624,3,4,4,11,Bronze
1130,1143,55,36,147650,3,3,2,8,Gold
1131,1144,22,165,406700,2,1,1,4,Platinum
1132,1145,8,178,2199752,1,1,1,3,Platinum
1133,1146,3,65,164781,1,2,2,5,Platinum
1134,1147,11,142,335563,1,1,1,3,Platinum
1135,1148,8,59,94242,1,2,2,5,Platinum
1136,1149,193,28,61916,4,3,3,10,Silver
1137,1150,72,16,30381,3,4,4,11,Bronze
1138,1151,205,19,43402,4,3,3,10,Silver
1139,1152,120,40,78040,3,3,3,9,Silver
1140,1153,94,15,47906,3,4,3,10,Silver
1141,1154,2,110,230839,1,1,1,3,Platinum
1142,1155,31,27,114051,2,3,2,7,Gold
1143,1156,298,21,91094,4,3,2,9,Silver
1144,1157,25,27,70640,2,3,3,8,Gold
1145,1158,29,118,327607,2,1,1,4,Platinum
1146,1159,52,17,40374,2,4,3,9,Silver
1147,1160,326,12,20510,4,4,4,12,Bronze
1148,1161,17,19,48270,1,3,3,7,Gold
1149,1162,193,43,95215,4,2,2,8,Gold
1150,1163,73,149,367834,3,1,1,5,Platinum
1151,1164,39,26,48894,2,3,3,8,Gold
1152,1165,80,122,309891,3,1,1,5,Platinum
1153,1166,61,148,391367,3,1,1,5,Platinum
1154,1167,13,33,79378,1,3,3,7,Gold
1155,1168,51,18,38358,2,3,4,9,Silver
1156,1169,50,30,165454,2,3,2,7,Gold
1157,1170,60,26,65936,3,3,3,9,Silver
1158,1171,352,7,21663,4,4,4,12,Bronze
1159,1172,54,20,45394,3,3,3,9,Silver
1160,1173,2,117,252346,1,1,1,3,Platinum
1161,1174,93,41,85393,3,3,3,9,Silver
1162,1175,24,11,28914,2,4,4,10,Silver
1163,1176,75,21,46706,3,3,3,9,Silver
1164,1177,12,27,53560,1,3,3,7,Gold
1165,1178,171,9,90573,4,4,2,10,Silver
1166,1179,58,17,48184,3,4,3,10,Silver
1167,1180,96,58,156517,3,2,2,7,Gold
1168,1181,295,16,34377,4,4,4,12,Bronze
1169,1182,110,23,71566,3,3,3,9,Silver
1170,1183,264,31,112988,4,3,2,9,Silver
1171,1184,180,26,53032,4,3,3,10,Silver
1172,1185,170,9,22725,4,4,4,12,Bronze
1173,1186,37,7,10592,2,4,4,10,Silver
1174,1187,24,45,105670,2,2,2,6,Gold
1175,1188,18,49,115174,1,2,2,5,Platinum
1176,1189,22,45,607342,2,2,1,5,Platinum
1177,1190,81,11,81029,3,4,3,10,Silver
1178,1191,69,5,10984,3,4,4,11,Bronze
1179,1192,365,3,13024,4,4,4,12,Bronze
1180,1193,3,160,357665,1,1,1,3,Platinum
1181,1194,12,35,92191,1,3,2,6,Gold
1182,1195,177,39,85597,4,3,3,10,Silver
1183,1196,218,136,405738,4,1,1,6,Gold
1184,1197,9,19,344286,1,3,1,5,Platinum
1185,1198,2,25,51916,1,3,3,7,Gold
1186,1199,155,33,40072,4,3,3,10,Silver
1187,1200,6,152,127086,1,1,2,4,Platinum
1188,1202,80,92,77954,3,2,3,8,Gold
1189,1203,22,12,29006,2,4,4,10,Silver
1190,1204,22,11,21924,2,4,4,10,Silver
1191,1205,309,35,91898,4,3,2,9,Silver
1192,1206,152,2,10530,4,4,4,12,Bronze
1193,1207,8,626,1124780,1,1,1,3,Platinum
1194,1208,19,149,368698,1,1,1,3,Platinum
1195,1209,72,15,25157,3,4,4,11,Bronze
1196,1210,289,11,33686,4,4,4,12,Bronze
1197,1211,50,28,53946,2,3,3,8,Gold
1198,1212,32,338,331466,2,1,1,4,Platinum
1199,1213,209,10,43178,4,4,3,11,Bronze
1200,1214,16,15,36851,1,4,4,9,Silver
1201,1215,74,54,121590,3,2,2,7,Gold
1202,1216,63,11,26950,3,4,4,11,Bronze
1203,1217,40,111,242037,2,1,1,4,Platinum
1204,1218,34,107,326702,2,1,1,4,Platinum
1205,1219,29,16,127492,2,4,2,8,Gold
1206,1220,5,351,888245,1,1,1,3,Platinum
1207,1221,20,13,43429,2,4,3,9,Silver
1208,1222,20,234,565276,2,1,1,4,Platinum
1209,1223,66,41,199572,3,3,2,8,Gold
1210,1224,214,16,42763,4,4,3,11,Bronze
1211,1225,13,83,130982,1,2,2,5,Platinum
1212,1226,31,5,10714,2,4,4,10,Silver
1213,1227,44,121,388165,2,1,1,4,Platinum
1214,1228,4,155,275868,1,1,1,3,Platinum
1215,1229,16,86,180996,1,2,2,5,Platinum
1216,1230,11,208,500790,1,1,1,3,Platinum
1217,1231,212,15,99240,4,4,2,10,Silver
1218,1232,46,39,258574,2,3,1,6,Gold
1219,1233,135,47,97239,3,2,2,7,Gold
1220,1234,44,171,599457,2,1,1,4,Platinum
1221,1235,10,84,408585,1,2,1,4,Platinum
1222,1236,118,30,127459,3,3,2,8,Gold
1223,1237,199,42,88479,4,2,2,8,Gold
1224,1238,280,11,40452,4,4,3,11,Bronze
1225,1239,111,34,72658,3,3,3,9,Silver
1226,1240,78,39,101776,3,3,2,8,Gold
1227,1241,53,20,112726,3,3,2,8,Gold
1228,1242,162,161,542697,4,1,1,6,Gold
1229,1243,47,66,191118,2,2,2,6,Gold
1230,1244,17,39,86924,1,3,2,6,Gold
1231,1245,156,22,72623,4,3,3,10,Silver
1232,1246,226,28,65219,4,3,3,10,Silver
1233,1247,8,31,77964,1,3,3,7,Gold
1234,1248,124,16,37972,3,4,4,11,Bronze
1235,1249,63,6,13908,3,4,4,11,Bronze
1236,1250,64,15,57438,3,4,3,10,Silver
1237,1251,19,243,307161,1,1,1,3,Platinum
1238,1252,9,248,1710795,1,1,1,3,Platinum
1239,1253,8,143,405933,1,1,1,3,Platinum
1240,1254,23,89,83545,2,2,3,7,Gold
1241,1255,29,66,174196,2,2,2,6,Gold
1242,1256,285,38,77308,4,3,3,10,Silver
1243,1257,177,28,17031,4,3,4,11,Bronze
1244,1258,79,92,202522,3,2,2,7,Gold
1245,1259,38,6,17888,2,4,4,10,Silver
1246,1260,43,235,442700,2,1,1,4,Platinum
1247,1261,267,21,19192,4,3,4,11,Bronze
1248,1262,27,209,81035,2,1,3,6,Gold
1249,1263,110,6,195522,3,4,2,9,Silver
1250,1264,285,13,30426,4,4,4,12,Bronze
1251,1265,9,32,152704,1,3,2,6,Gold
1252,1266,306,85,54641,4,2,3,9,Silver
1253,1267,17,488,765738,1,1,1,3,Platinum
1254,1268,32,54,111085,2,2,2,6,Gold
1255,1269,1,210,1767931,1,1,1,3,Platinum
1256,1270,20,56,27949,2,2,4,8,Gold
1257,1271,128,4,33890,3,4,4,11,Bronze
1258,1272,66,6,12644,3,4,4,11,Bronze
1259,1273,107,10,79132,3,4,3,10,Silver
1260,1274,2,1106,1031327,1,1,1,3,Platinum
1261,1275,25,284,877086,2,1,1,4,Platinum
1262,1276,267,8,27568,4,4,4,12,Bronze
1263,1277,5,202,892064,1,1,1,3,Platinum
1264,1278,10,111,1349698,1,1,1,3,Platinum
1265,1279,30,80,236586,2,2,1,5,Platinum
1266,1280,267,7,17433,4,4,4,12,Bronze
1267,1281,64,52,56690,3,2,3,8,Gold
1268,1282,321,24,29822,4,3,4,11,Bronze
1269,1283,4,322,193682,1,1,2,4,Platinum
1270,1284,33,13,19462,2,4,4,10,Silver
1271,1285,5,43,131134,1,2,2,5,Platinum
1272,1286,130,46,16265,3,2,4,9,Silver
1273,1287,44,42,63392,2,2,3,7,Gold
1274,1288,102,65,118844,3,2,2,7,Gold
1275,1289,126,12,53136,3,4,3,10,Silver
1276,1290,37,4,6492,2,4,4,10,Silver
1277,1291,303,152,122315,4,1,2,7,Gold
1278,1292,365,29,24900,4,3,4,11,Bronze
1279,1293,5,181,142996,1,1,2,4,Platinum
1280,1294,3,450,614012,1,1,1,3,Platinum
1281,1295,3,69,34777,1,2,4,7,Gold
1282,1296,11,589,5678995,1,1,1,3,Platinum
1283,1297,58,14,23739,3,4,4,11,Bronze
1284,1298,326,1,8352,4,4,4,12,Bronze
1285,1299,8,214,510004,1,1,1,3,Platinum
1286,1300,13,105,60215,1,1,3,5,Platinum
1287,1301,5,5095,6154642,1,1,1,3,Platinum
1288,1302,37,21,19091,2,3,4,9,Silver
1289,1303,17,250,421621,1,1,1,3,Platinum
1290,1304,138,26,22838,3,3,4,10,Silver
1291,1305,75,34,795177,3,3,1,7,Gold
1292,1306,8,79,181735,1,2,2,5,Platinum
1293,1307,155,21,26096,4,3,4,11,Bronze
1294,1308,240,74,170278,4,2,2,8,Gold
1295,1309,52,123,362951,2,1,1,4,Platinum
1296,1310,31,34,75647,2,3,3,8,Gold
1297,1311,73,9,18446,3,4,4,11,Bronze
1298,1312,5,156,706082,1,1,1,3,Platinum
1299,1313,16,10,95841,1,4,2,7,Gold
1300,1314,26,160,375871,2,1,1,4,Platinum
1301,1315,4,34,219822,1,3,1,5,Platinum
1302,1316,276,15,43651,4,4,3,11,Bronze
1303,1317,22,72,175489,2,2,2,6,Gold
1304,1318,145,3,13704,4,4,4,12,Bronze
1305,1320,4,159,381197,1,1,1,3,Platinum
1306,1321,85,5,111164,3,4,2,9,Silver
1307,1322,11,167,362428,1,1,1,3,Platinum
1308,1323,10,15,86422,1,4,2,7,Gold
1309,1324,124,44,89151,3,2,2,7,Gold
1310,1325,61,46,90653,3,2,2,7,Gold
1311,1326,2,52,144699,1,2,2,5,Platinum
1312,1327,320,67,63884,4,2,3,9,Silver
1313,1328,3,200,531780,1,1,1,3,Platinum
1314,1329,130,28,77181,3,3,3,9,Silver
1315,1330,2,134,666799,1,1,1,3,Platinum
1316,1331,3,47,127049,1,2,2,5,Platinum
1317,1332,47,26,64788,2,3,3,8,Gold
1318,1333,4,66,132154,1,2,2,5,Platinum
1319,1334,4,40,110735,1,3,2,6,Gold
1320,1335,374,22,45056,4,3,3,10,Silver
1321,1336,135,7,12842,3,4,4,11,Bronze
1322,1337,47,11,414756,2,4,1,7,Gold
1323,1338,9,210,542129,1,1,1,3,Platinum
1324,1339,84,5,53036,3,4,3,10,Silver
1325,1340,234,3,16640,4,4,4,12,Bronze
1326,1341,221,28,55953,4,3,3,10,Silver
1327,1342,37,26,90914,2,3,2,7,Gold
1328,1343,76,49,97488,3,2,2,7,Gold
1329,1344,240,52,161084,4,2,2,8,Gold
1330,1345,267,6,12968,4,4,4,12,Bronze
1331,1346,10,1384,12657119,1,1,1,3,Platinum
1332,1347,20,48,55258,2,2,3,7,Gold
1333,1348,41,41,86224,2,3,2,7,Gold
1334,1349,20,1203,688129,2,1,1,4,Platinum
1335,1350,216,108,136553,4,1,2,7,Gold
1336,1351,174,25,36425,4,3,4,11,Bronze
1337,1352,88,52,297296,3,2,1,6,Gold
1338,1353,80,29,220734,3,3,1,7,Gold
1339,1354,276,25,14751,4,3,4,11,Bronze
1340,1355,40,52,66512,2,2,3,7,Gold
1341,1356,99,58,46170,3,2,3,8,Gold
1342,1357,11,29,52999,1,3,3,7,Gold
1343,1358,34,26,18334,2,3,4,9,Silver
1344,1359,60,149,394867,3,1,1,5,Platinum
1345,1360,298,31,67577,4,3,3,10,Silver
1346,1361,88,42,67158,3,2,3,8,Gold
1347,1362,9,325,237192,1,1,1,3,Platinum
1348,1363,41,165,86982,2,1,2,5,Platinum
1349,1364,11,240,510188,1,1,1,3,Platinum
1350,1365,67,24,51181,3,3,3,9,Silver
1351,1366,332,3,20166,4,4,4,12,Bronze
1352,1367,32,65,259588,2,2,1,5,Platinum
1353,1368,3,265,668644,1,1,1,3,Platinum
1354,1369,2,259,647781,1,1,1,3,Platinum
1355,1370,68,42,106222,3,2,2,7,Gold
1356,1371,5,579,1425416,1,1,1,3,Platinum
1357,1372,203,7,163280,4,4,2,10,Silver
1358,1373,107,6,41114,3,4,3,10,Silver
1359,1374,19,39,84158,1,3,3,7,Gold
1360,1375,221,2,19752,4,4,4,12,Bronze
1361,1376,61,37,112072,3,3,2,8,Gold
1362,1377,3,44,19978,1,2,4,7,Gold
1363,1378,18,24,58684,1,3,3,7,Gold
1364,1379,240,20,46408,4,3,3,10,Silver
1365,1380,95,10,17337,3,4,4,11,Bronze
1366,1381,11,87,245034,1,2,1,4,Platinum
1367,1382,106,102,228327,3,1,1,5,Platinum
1368,1383,54,112,284329,3,1,1,5,Platinum
1369,1384,91,9,155680,3,4,2,9,Silver
1370,1386,31,67,137022,2,2,2,6,Gold
1371,1387,12,108,246182,1,1,1,3,Platinum
1372,1388,5,59,215044,1,2,1,4,Platinum
1373,1389,3,100,238496,1,2,1,4,Platinum
1374,1390,43,12,26476,2,4,4,10,Silver
1375,1391,6,7,13646,1,4,4,9,Silver
1376,1392,249,21,76886,4,3,3,10,Silver
1377,1393,43,193,456732,2,1,1,4,Platinum
1378,1394,178,41,96639,4,3,2,9,Silver
1379,1395,93,60,123779,3,2,2,7,Gold
1380,1396,111,118,130636,3,1,2,6,Gold
1381,1397,30,67,286835,2,2,1,5,Platinum
1382,1398,27,175,430266,2,1,1,4,Platinum
1383,1399,52,40,189213,2,3,2,7,Gold
1384,1400,184,50,111794,4,2,2,8,Gold
1385,1401,43,115,295818,2,1,1,4,Platinum
1386,1402,50,35,169570,2,3,2,7,Gold
1387,1403,23,159,119867,2,1,2,5,Platinum
1388,1404,76,79,406774,3,2,1,6,Gold
1389,1405,81,15,63854,3,4,3,10,Silver
1390,1406,374,9,17633,4,4,4,12,Bronze
1391,1407,329,8,20847,4,4,4,12,Bronze
1392,1408,44,112,289509,2,1,1,4,Platinum
1393,1409,31,42,107479,2,2,2,6,Gold
1394,1410,184,10,27340,4,4,4,12,Bronze
1395,1411,235,16,34381,4,4,4,12,Bronze
1396,1412,11,141,317557,1,1,1,3,Platinum
1397,1413,220,108,217525,4,1,1,6,Gold
1398,1414,111,75,182781,3,2,2,7,Gold
1399,1415,279,20,15917,4,3,4,11,Bronze
1400,1416,320,8,36582,4,4,4,12,Bronze
1401,1417,8,111,245538,1,1,1,3,Platinum
1402,1418,2,78,382408,1,2,1,4,Platinum
1403,1419,261,53,118512,4,2,2,8,Gold
1404,1420,65,106,409986,3,1,1,5,Platinum
1405,1421,10,111,1556962,1,1,1,3,Platinum
1406,1422,143,5,16202,3,4,4,11,Bronze
1407,1423,51,52,139383,2,2,2,6,Gold
1408,1424,9,143,345454,1,1,1,3,Platinum
1409,1425,155,17,38063,4,4,4,12,Bronze
1410,1426,110,31,68153,3,3,3,9,Silver
1411,1427,163,55,176636,4,2,2,8,Gold
1412,1428,332,29,57851,4,3,3,10,Silver
1413,1429,226,10,15960,4,4,4,12,Bronze
1414,1430,74,33,75485,3,3,3,9,Silver
1415,1431,55,29,67670,3,3,3,9,Silver
1416,1432,99,64,143686,3,2,2,7,Gold
1417,1433,16,224,511601,1,1,1,3,Platinum
1418,1434,197,8,14544,4,4,4,12,Bronze
1419,1435,4,156,494639,1,1,1,3,Platinum
1420,1436,31,32,66913,2,3,3,8,Gold
1421,1437,22,27,216966,2,3,1,6,Gold
1422,1438,24,280,699832,2,1,1,4,Platinum
1423,1439,10,9,37573,1,4,4,9,Silver
1424,1440,214,16,53474,4,4,3,11,Bronze
1425,1441,9,47,104944,1,2,2,5,Platinum
1426,1442,12,101,277766,1,1,1,3,Platinum
1427,1443,2,237,526528,1,1,1,3,Platinum
1428,1444,9,100,557435,1,2,1,4,Platinum
1429,1445,4,61,137983,1,2,2,5,Platinum
1430,1446,41,5,18228,2,4,4,10,Silver
1431,1447,18,62,180733,1,2,2,5,Platinum
1432,1448,9,1636,7900365,1,1,1,3,Platinum
1433,1449,9,143,510589,1,1,1,3,Platinum
1434,1450,27,3,6260,2,4,4,10,Silver
1435,1451,118,13,89294,3,4,2,9,Silver
1436,1452,223,17,45888,4,4,3,11,Bronze
1437,1453,72,105,238832,3,1,1,5,Platinum
1438,1454,54,33,253216,3,3,1,7,Gold
1439,1455,89,180,406460,3,1,1,5,Platinum
1440,1456,9,117,313980,1,1,1,3,Platinum
1441,1457,243,20,36123,4,3,4,11,Bronze
1442,1458,47,87,211767,2,2,1,5,Platinum
1443,1459,108,8,26668,3,4,4,11,Bronze
1444,1460,45,101,297457,2,1,1,4,Platinum
1445,1461,65,24,65239,3,3,3,9,Silver
1446,1462,207,31,64807,4,3,3,10,Silver
1447,1463,12,123,268579,1,1,1,3,Platinum
1448,1464,115,36,73120,3,3,3,9,Silver
1449,1465,244,8,22743,4,4,4,12,Bronze
1450,1466,164,12,37517,4,4,4,12,Bronze
1451,1467,18,259,655085,1,1,1,3,Platinum
1452,1468,127,28,57222,3,3,3,9,Silver
1453,1469,23,26,110761,2,3,2,7,Gold
1454,1470,68,15,44714,3,4,3,10,Silver
1455,1471,17,162,344571,1,1,1,3,Platinum
1456,1472,17,63,67259,1,2,3,6,Gold
1457,1473,17,90,248572,1,2,1,4,Platinum
1458,1474,163,31,79743,4,3,3,10,Silver
1459,1475,243,14,38856,4,4,4,12,Bronze
1460,1476,220,6,15558,4,4,4,12,Bronze
1461,1477,46,129,287886,2,1,1,4,Platinum
1462,1478,23,21,88141,2,3,2,7,Gold
1463,1479,128,71,110450,3,2,2,7,Gold
1464,1480,39,6,14778,2,4,4,10,Silver
1465,1481,121,60,127255,3,2,2,7,Gold
1466,1482,261,18,49797,4,3,3,10,Silver
1467,1483,11,31,18220,1,3,4,8,Gold
1468,1484,275,18,39398,4,3,3,10,Silver
1469,1485,169,1,5136,4,4,4,12,Bronze
1470,1486,159,47,129929,4,2,2,8,Gold
1471,1487,216,6,13498,4,4,4,12,Bronze
1472,1488,6,9,27672,1,4,4,9,Silver
1473,1489,368,11,23380,4,4,4,12,Bronze
1474,1490,80,33,82772,3,3,3,9,Silver
1475,1491,44,41,29939,2,3,4,9,Silver
1476,1492,20,55,109881,2,2,2,6,Gold
1477,1493,32,118,269098,2,1,1,4,Platinum
1478,1494,23,41,21284,2,3,4,9,Silver
1479,1495,109,69,452903,3,2,1,6,Gold
1480,1496,9,524,1156866,1,1,1,3,Platinum
1481,1497,320,8,17560,4,4,4,12,Bronze
1482,1498,296,4,11970,4,4,4,12,Bronze
1483,1499,359,4,8157,4,4,4,12,Bronze
1484,1500,186,75,35113,4,2,4,10,Silver
1485,1501,193,11,66077,4,4,3,11,Bronze
1486,1502,45,46,50804,2,2,3,7,Gold
1487,1503,53,56,29008,3,2,4,9,Silver
1488,1504,27,131,127119,2,1,2,5,Platinum
1489,1505,39,59,164687,2,2,2,6,Gold
1490,1506,10,14,29451,1,4,4,9,Silver
1491,1507,299,7,17106,4,4,4,12,Bronze
1492,1508,33,140,213477,2,1,1,4,Platinum
1493,1509,11,186,425616,1,1,1,3,Platinum
1494,1510,66,45,142459,3,2,2,7,Gold
1495,1511,11,286,563467,1,1,1,3,Platinum
1496,1512,219,5,7542,4,4,4,12,Bronze
1497,1513,3,350,433236,1,1,1,3,Platinum
1498,1514,66,73,59115,3,2,3,8,Gold
1499,1515,3,87,380216,1,2,1,4,Platinum
1500,1516,150,25,80191,4,3,3,10,Silver
1501,1517,5,182,641287,1,1,1,3,Platinum
1502,1518,132,20,177300,3,3,2,8,Gold
1503,1519,34,103,196884,2,1,2,5,Platinum
1504,1520,121,8,17617,3,4,4,11,Bronze
1505,1521,108,72,294027,3,2,1,6,Gold
1506,1522,12,107,347933,1,1,1,3,Platinum
1507,1523,73,54,259829,3,2,1,6,Gold
1508,1524,93,193,136848,3,1,2,6,Gold
1509,1525,312,14,117732,4,4,2,10,Silver
1510,1526,45,43,116595,2,2,2,6,Gold
1511,1527,364,23,15742,4,3,4,11,Bronze
1512,1528,92,97,287920,3,2,1,6,Gold
1513,1529,2,590,736706,1,1,1,3,Platinum
1514,1530,26,14,58676,2,4,3,9,Silver
1515,1531,4,124,278777,1,1,1,3,Platinum
1516,1532,11,206,129563,1,1,2,4,Platinum
1517,1533,100,29,54984,3,3,3,9,Silver
1518,1534,61,27,99077,3,3,2,8,Gold
1519,1535,1,222,567388,1,1,1,3,Platinum
1520,1536,221,3,33816,4,4,4,12,Bronze
1521,1537,26,1,34944,2,4,4,10,Silver
1522,1538,24,224,569564,2,1,1,4,Platinum
1523,1539,53,17,47024,3,4,3,10,Silver
1524,1540,8,144,149877,1,1,2,4,Platinum
1525,1541,303,17,53464,4,4,3,11,Bronze
1526,1542,10,382,323693,1,1,1,3,Platinum
1527,1543,28,12,161344,2,4,2,8,Gold
1528,1544,99,9,15645,3,4,4,11,Bronze
1529,1545,367,5,9228,4,4,4,12,Bronze
1530,1546,307,9,18894,4,4,4,12,Bronze
1531,1547,320,32,293010,4,3,1,8,Gold
1532,1548,10,55,263435,1,2,1,4,Platinum
1533,1549,2,51,193695,1,2,2,5,Platinum
1534,1550,205,63,186819,4,2,2,8,Gold
1535,1551,54,93,195546,3,2,2,7,Gold
1536,1552,1,292,147299,1,1,2,4,Platinum
1537,1553,19,70,145039,1,2,2,5,Platinum
1538,1554,12,20,41384,1,3,3,7,Gold
1539,1555,19,258,126183,1,1,2,4,Platinum
1540,1556,181,40,60870,4,3,3,10,Silver
1541,1557,61,109,81945,3,1,3,7,Gold
1542,1558,11,62,32055,1,2,4,7,Gold
1543,1559,191,22,13828,4,3,4,11,Bronze
1544,1560,6,968,443793,1,1,1,3,Platinum
1545,1561,311,4,15568,4,4,4,12,Bronze
1546,1562,156,37,221540,4,3,1,8,Gold
1547,1563,113,16,76815,3,4,3,10,Silver
1548,1564,149,179,253190,4,1,1,6,Gold
1549,1565,67,239,244752,3,1,1,5,Platinum
1550,1566,103,6,61795,3,4,3,10,Silver
1551,1567,247,130,128286,4,1,2,7,Gold
1552,1568,30,72,280035,2,2,1,5,Platinum
1553,1569,18,90,74019,1,2,3,6,Gold
1554,1570,12,43,57391,1,2,3,6,Gold
1555,1571,104,281,251361,3,1,1,5,Platinum
1556,1572,78,7,24418,3,4,4,11,Bronze
1557,1573,47,29,60966,2,3,3,8,Gold
1558,1574,73,42,113942,3,2,2,7,Gold
1559,1575,258,19,28023,4,3,4,11,Bronze
1560,1576,20,10,175220,2,4,2,8,Gold
1561,1577,254,18,38428,4,3,4,11,Bronze
1562,1578,12,13,32480,1,4,4,9,Silver
1563,1579,165,30,90227,4,3,2,9,Silver
1564,1580,19,144,287824,1,1,1,3,Platinum
1565,1581,282,9,17939,4,4,4,12,Bronze
1566,1582,52,14,40440,2,4,3,9,Silver
1567,1583,39,47,19926,2,2,4,8,Gold
1568,1584,28,144,153550,2,1,2,5,Platinum
1569,1585,68,46,142084,3,2,2,7,Gold
1570,1586,208,30,62774,4,3,3,10,Silver
1571,1587,176,17,42777,4,4,3,11,Bronze
1572,1588,8,120,299201,1,1,1,3,Platinum
1573,1589,26,7,19152,2,4,4,10,Silver
1574,1590,52,6,16136,2,4,4,10,Silver
1575,1591,312,19,64204,4,3,3,10,Silver
1576,1592,310,29,60049,4,3,3,10,Silver
1577,1593,43,193,248906,2,1,1,4,Platinum
1578,1594,27,194,108074,2,1,2,5,Platinum
1579,1595,89,7,42345,3,4,3,10,Silver
1580,1596,185,10,35553,4,4,4,12,Bronze
1581,1597,20,623,318158,2,1,1,4,Platinum
1582,1598,4,164,452984,1,1,1,3,Platinum
1583,1599,48,107,83233,2,1,3,6,Gold
1584,1600,18,799,729392,1,1,1,3,Platinum
1585,1601,18,316,237251,1,1,1,3,Platinum
1586,1602,26,96,164389,2,2,2,6,Gold
1587,1603,23,57,33235,2,2,4,8,Gold
1588,1604,12,68,172447,1,2,2,5,Platinum
1589,1605,189,23,34334,4,3,4,11,Bronze
1590,1606,109,12,54902,3,4,3,10,Silver
1591,1607,63,73,139457,3,2,2,7,Gold
1592,1608,18,101,264900,1,1,1,3,Platinum
1593,1609,37,18,38560,2,3,4,9,Silver
1594,1610,67,16,35220,3,4,4,11,Bronze
1595,1611,5,4,36978,1,4,4,9,Silver
1596,1612,33,17,115313,2,4,2,8,Gold
1597,1613,109,12,40506,3,4,3,10,Silver
1598,1614,35,203,222070,2,1,1,4,Platinum
1599,1615,20,291,572116,2,1,1,4,Platinum
1600,1616,3,971,955662,1,1,1,3,Platinum
1601,1617,38,18,54920,2,3,3,8,Gold
1602,1618,61,229,79035,3,1,3,7,Gold
1603,1619,26,216,370024,2,1,1,4,Platinum
1604,1620,237,64,113282,4,2,2,8,Gold
1605,1621,25,61,337858,2,2,1,5,Platinum
1606,1622,3,518,544749,1,1,1,3,Platinum
1607,1623,61,330,370210,3,1,1,5,Platinum
1608,1624,260,19,19192,4,3,4,11,Bronze
1609,1625,58,10,41700,3,4,3,10,Silver
1610,1626,65,19,45958,3,3,3,9,Silver
1611,1627,16,32,80631,1,3,3,7,Gold
1612,1628,10,76,123707,1,2,2,5,Platinum
1613,1629,59,111,178550,3,1,2,6,Gold
1614,1630,189,5,11411,4,4,4,12,Bronze
1615,1631,30,69,393836,2,2,1,5,Platinum
1616,1632,25,114,276356,2,1,1,4,Platinum
1617,1633,6,399,325608,1,1,1,3,Platinum
1618,1634,4,366,528102,1,1,1,3,Platinum
1619,1635,155,4,72480,4,4,3,11,Bronze
1620,1636,312,56,37940,4,2,4,10,Silver
1621,1637,11,48,99340,1,2,2,5,Platinum
1622,1638,19,10,24943,1,4,4,9,Silver
1623,1639,152,58,20448,4,2,4,10,Silver
1624,1640,20,113,110956,2,1,2,5,Platinum
1625,1641,11,216,306003,1,1,1,3,Platinum
1626,1642,59,21,40579,3,3,3,9,Silver
1627,1643,86,16,103568,3,4,2,9,Silver
1628,1644,14,74,286492,1,2,1,4,Platinum
1629,1645,76,69,155530,3,2,2,7,Gold
1630,1646,4,423,601307,1,1,1,3,Platinum
1631,1647,96,127,388493,3,1,1,5,Platinum
1632,1648,113,4,167200,3,4,2,9,Silver
1633,1649,58,33,176068,3,3,2,8,Gold
1634,1650,3,12,28144,1,4,4,9,Silver
1635,1651,281,28,25610,4,3,4,11,Bronze
1636,1652,6,270,351415,1,1,1,3,Platinum
1637,1653,182,235,192326,4,1,2,7,Gold
1638,1654,380,1,4392,4,4,4,12,Bronze
1639,1655,13,123,105074,1,1,2,4,Platinum
1640,1656,4,24,32711,1,3,4,8,Gold
1641,1657,17,17,21507,1,4,4,9,Silver
1642,1658,41,6,15354,2,4,4,10,Silver
1643,1659,6,330,142588,1,1,2,4,Platinum
1644,1660,171,100,124958,4,2,2,8,Gold
1645,1661,51,29,20956,2,3,4,9,Silver
1646,1662,277,19,45450,4,3,3,10,Silver
1647,1663,19,383,197828,1,1,2,4,Platinum
1648,1664,374,3,4386,4,4,4,12,Bronze
1649,1665,16,197,206573,1,1,2,4,Platinum
1650,1666,36,164,77649,2,1,3,6,Gold
1651,1667,22,152,79154,2,1,3,6,Gold
1652,1668,8,53,46017,1,2,3,6,Gold
1653,1669,20,102,226026,2,1,1,4,Platinum
1654,1670,12,55,116019,1,2,2,5,Platinum
1655,1671,45,50,31473,2,2,4,8,Gold
1656,1672,306,25,45334,4,3,3,10,Silver
1657,1673,15,7,27996,1,4,4,9,Silver
1658,1674,279,2,74400,4,4,3,11,Bronze
1659,1675,2,2698,1509813,1,1,1,3,Platinum
1660,1676,18,74,1502600,1,2,1,4,Platinum
1661,1677,5,20,205119,1,3,2,6,Gold
1662,1678,79,3,204930,3,4,2,9,Silver
1663,1679,250,3,43984,4,4,3,11,Bronze
1664,1680,11,16,69108,1,4,3,8,Gold
1665,1681,246,20,46434,4,3,3,10,Silver
1666,1682,206,26,53200,4,3,3,10,Silver
1667,1683,2,92,236780,1,2,1,4,Platinum
1668,1684,185,21,38409,4,3,4,11,Bronze
1669,1685,33,133,109435,2,1,2,5,Platinum
1670,1686,60,13,29593,3,4,4,11,Bronze
1671,1687,197,53,106512,4,2,2,8,Gold
1672,1688,24,122,344789,2,1,1,4,Platinum
1673,1690,93,24,78302,3,3,3,9,Silver
1674,1691,5,152,116404,1,1,2,4,Platinum
1675,1692,52,41,127888,2,3,2,7,Gold
1676,1693,263,8,16714,4,4,4,12,Bronze
1677,1694,267,20,39890,4,3,3,10,Silver
1678,1695,37,28,75005,2,3,3,8,Gold
1679,1696,51,16,53641,2,4,3,9,Silver
1680,1697,53,172,368703,3,1,1,5,Platinum
1681,1698,25,106,254627,2,1,1,4,Platinum
1682,1699,23,7,16182,2,4,4,10,Silver
1683,1700,63,2,9908,3,4,4,11,Bronze
1684,1701,171,31,111294,4,3,2,9,Silver
1685,1702,68,26,94906,3,3,2,8,Gold
1686,1703,157,30,77363,4,3,3,10,Silver
1687,1704,3,2053,35536194,1,1,1,3,Platinum
1688,1705,202,30,27552,4,3,4,11,Bronze
1689,1706,5,199,191337,1,1,2,4,Platinum
1690,1707,68,102,83133,3,1,3,7,Gold
1691,1708,78,29,13846,3,3,4,10,Silver
1692,1709,2,236,246076,1,1,1,3,Platinum
1693,1710,9,49,252618,1,2,1,4,Platinum
1694,1711,170,80,35462,4,2,4,10,Silver
1695,1712,18,126,107454,1,1,2,4,Platinum
1696,1713,6,29,26782,1,3,4,8,Gold
1697,1714,10,253,311145,1,1,1,3,Platinum
1698,1715,87,30,41033,3,3,3,9,Silver
1699,1716,27,4,12447,2,4,4,10,Silver
1700,1717,29,168,107056,2,1,2,5,Platinum
1701,1718,20,99,86035,2,2,3,7,Gold
1702,1719,62,90,220593,3,2,1,6,Gold
1703,1720,25,13,26097,2,4,4,10,Silver
1704,1721,11,572,1181021,1,1,1,3,Platinum
1705,1722,242,170,168178,4,1,2,7,Gold
1706,1723,281,132,56488,4,1,3,8,Gold
1707,1724,235,61,100905,4,2,2,8,Gold
1708,1725,4,74,226239,1,2,1,4,Platinum
1709,1726,17,102,79289,1,1,3,5,Platinum
1710,1727,32,42,380500,2,2,1,5,Platinum
1711,1729,29,258,3537371,2,1,1,4,Platinum
1712,1730,77,7,53090,3,4,3,10,Silver
1713,1731,194,2,9472,4,4,4,12,Bronze
1714,1732,26,421,165839,2,1,2,5,Platinum
1715,1733,107,15,81994,3,4,3,10,Silver
1716,1734,8,327,745863,1,1,1,3,Platinum
1717,1735,209,13,15043,4,4,4,12,Bronze
1718,1736,45,50,46423,2,2,3,7,Gold
1719,1737,31,71,246838,2,2,1,5,Platinum
1720,1738,138,68,75389,3,2,3,8,Gold
1721,1739,265,8,18819,4,4,4,12,Bronze
1722,1740,5,130,303584,1,1,1,3,Platinum
1723,1741,219,22,30584,4,3,4,11,Bronze
1724,1742,2,210,156588,1,1,2,4,Platinum
1725,1743,215,8,14899,4,4,4,12,Bronze
1726,1744,33,115,292277,2,1,1,4,Platinum
1727,1745,11,335,301607,1,1,1,3,Platinum
1728,1746,2,347,408773,1,1,1,3,Platinum
1729,1747,15,22,39919,1,3,3,7,Gold
1730,1748,15,414,207627,1,1,2,4,Platinum
1731,1749,199,1,25300,4,4,4,12,Bronze
1732,1750,3,28,137603,1,3,2,6,Gold
1733,1751,16,196,612321,1,1,1,3,Platinum
1734,1752,15,139,79226,1,1,3,5,Platinum
1735,1753,11,357,334341,1,1,1,3,Platinum
1736,1754,31,25,107659,2,3,2,7,Gold
1737,1755,11,339,341794,1,1,1,3,Platinum
1738,1756,26,10,20408,2,4,4,10,Silver
1739,1757,26,71,116581,2,2,2,6,Gold
1740,1758,44,55,69040,2,2,3,7,Gold
1741,1759,2,237,214233,1,1,1,3,Platinum
1742,1760,7,37,77497,1,3,3,7,Gold
1743,1761,148,29,23305,4,3,4,11,Bronze
1744,1762,11,277,149254,1,1,2,4,Platinum
1745,1763,25,52,104020,2,2,2,6,Gold
1746,1764,275,10,30342,4,4,4,12,Bronze
1747,1765,374,71,41251,4,2,3,9,Silver
1748,1766,2,501,258769,1,1,1,3,Platinum
1749,1767,48,45,51641,2,2,3,7,Gold
1750,1768,10,147,351601,1,1,1,3,Platinum
1751,1769,19,202,1145823,1,1,1,3,Platinum
1752,1770,5,193,725233,1,1,1,3,Platinum
1753,1771,8,17,136049,1,4,2,7,Gold
1754,1772,43,54,162134,2,2,2,6,Gold
1755,1773,7,60,587068,1,2,1,4,Platinum
1756,1774,198,89,179957,4,2,2,8,Gold
1757,1775,12,59,184082,1,2,2,5,Platinum
1758,1776,21,26,140995,2,3,2,7,Gold
1759,1777,113,69,172509,3,2,2,7,Gold
1760,1778,250,18,36882,4,3,4,11,Bronze
1761,1779,30,89,201487,2,2,2,6,Gold
1762,1780,44,5,48988,2,4,3,9,Silver
1763,1781,88,30,66570,3,3,3,9,Silver
1764,1782,45,41,86032,2,3,3,8,Gold
1765,1783,10,235,614185,1,1,1,3,Platinum
1766,1784,16,38,98671,1,3,2,6,Gold
1767,1785,78,19,48678,3,3,3,9,Silver
1768,1786,145,71,171479,4,2,2,8,Gold
1769,1787,5,102,190759,1,1,2,4,Platinum
1770,1788,299,5,10638,4,4,4,12,Bronze
1771,1789,62,11,31906,3,4,4,11,Bronze
1772,1790,264,21,42948,4,3,3,10,Silver
1773,1791,48,6,33570,2,4,4,10,Silver
1774,1792,30,39,32587,2,3,4,9,Silver
1775,1793,9,135,313934,1,1,1,3,Platinum
1776,1794,21,5,22966,2,4,4,10,Silver
1777,1795,3,1089,1450733,1,1,1,3,Platinum
1778,1796,233,52,112967,4,2,2,8,Gold
1779,1797,114,9,18474,3,4,4,11,Bronze
1780,1798,59,60,168226,3,2,2,7,Gold
1781,1799,53,117,403903,3,1,1,5,Platinum
1782,1801,128,35,91192,3,3,2,8,Gold
1783,1802,282,41,43206,4,3,3,10,Silver
1784,1803,55,27,59968,3,3,3,9,Silver
1785,1804,320,6,21854,4,4,4,12,Bronze
1786,1805,27,15,44303,2,4,3,9,Silver
1787,1806,19,3,12216,1,4,4,9,Silver
1788,1807,8,30,83272,1,3,3,7,Gold
1789,1808,30,6,26712,2,4,4,10,Silver
1790,1809,17,46,111524,1,2,2,5,Platinum
1791,1810,67,2,763,3,4,4,11,Bronze
1792,1811,22,14,27145,2,4,4,10,Silver
1793,1812,3,80,166325,1,2,2,5,Platinum
1794,1813,167,6,14052,4,4,4,12,Bronze
1795,1814,2,1140,1117544,1,1,1,3,Platinum
1796,1815,54,12,24504,3,4,4,11,Bronze
1797,1816,52,13,22090,2,4,4,10,Silver
1798,1817,48,385,607608,2,1,1,4,Platinum
1799,1818,62,59,29522,3,2,4,9,Silver
1800,1819,163,44,107256,4,2,2,8,Gold
1801,1820,9,12,42045,1,4,3,8,Gold
1802,1821,16,47,61855,1,2,3,6,Gold
1803,1822,76,11,35983,3,4,4,11,Bronze
1804,1823,40,235,380223,2,1,1,4,Platinum
1805,1824,41,255,258425,2,1,1,4,Platinum
1806,1825,370,30,18153,4,3,4,11,Bronze
1807,1826,37,53,114256,2,2,2,6,Gold
1808,1827,200,4,27391,4,4,4,12,Bronze
1809,1828,201,63,139899,4,2,2,8,Gold
1810,1829,74,48,81716,3,2,3,8,Gold
1811,1830,66,13,34354,3,4,4,11,Bronze
1812,1831,23,29,64970,2,3,3,8,Gold
1813,1832,369,2,5468,4,4,4,12,Bronze
1814,1833,181,70,36502,4,2,4,10,Silver
1815,1834,11,29,145640,1,3,2,6,Gold
1816,1835,5,121,270697,1,1,1,3,Platinum
1817,1836,197,16,273640,4,4,1,9,Silver
1818,1837,30,42,91732,2,2,2,6,Gold
1819,1838,54,39,27858,3,3,4,10,Silver
1820,1839,18,67,215095,1,2,1,4,Platinum
1821,1840,17,6,12428,1,4,4,9,Silver
1822,1841,90,108,233829,3,1,1,5,Platinum
1823,1842,268,4,7944,4,4,4,12,Bronze
1824,1843,54,138,421070,3,1,1,5,Platinum
1825,1844,44,145,336793,2,1,1,4,Platinum
1826,1845,64,130,407812,3,1,1,5,Platinum
1827,1846,149,13,38098,4,4,4,12,Bronze
1828,1847,22,388,1072529,2,1,1,4,Platinum
1829,1848,312,21,51274,4,3,3,10,Silver
1830,1849,25,28,70133,2,3,3,8,Gold
1831,1850,59,143,373013,3,1,1,5,Platinum
1832,1851,25,9,51752,2,4,3,9,Silver
1833,1852,79,126,373319,3,1,1,5,Platinum
1834,1853,120,20,79087,3,3,3,9,Silver
1835,1854,37,66,166372,2,2,2,6,Gold
1836,1855,60,60,141046,3,2,2,7,Gold
1837,1856,13,58,164378,1,2,2,5,Platinum
1838,1857,20,11,26212,2,4,4,10,Silver
1839,1858,54,6,20682,3,4,4,11,Bronze
1840,1859,26,48,115916,2,2,2,6,Gold
1841,1860,32,11,32664,2,4,4,10,Silver
1842,1861,17,4,14376,1,4,4,9,Silver
1843,1862,11,97,1667131,1,2,1,4,Platinum
1844,1863,186,36,85852,4,3,3,10,Silver
1845,1864,4,144,369874,1,1,1,3,Platinum
1846,1865,9,71,101377,1,2,2,5,Platinum
1847,1866,262,13,38863,4,4,4,12,Bronze
1848,1867,4,98,60948,1,2,3,6,Gold
1849,1868,211,28,61344,4,3,3,10,Silver
1850,1869,108,47,173063,3,2,2,7,Gold
1851,1870,13,124,182933,1,1,2,4,Platinum
1852,1871,79,47,89447,3,2,2,7,Gold
1853,1872,20,17,37892,2,4,4,10,Silver
1854,1873,27,11,68888,2,4,3,9,Silver
1855,1874,21,53,117842,2,2,2,6,Gold
1856,1875,132,15,127664,3,4,2,9,Silver
1857,1876,253,18,44708,4,3,3,10,Silver
1858,1877,81,6,227500,3,4,1,8,Gold
1859,1878,209,20,45946,4,3,3,10,Silver
1860,1879,338,10,19230,4,4,4,12,Bronze
1861,1880,255,7,14797,4,4,4,12,Bronze
1862,1881,149,33,81711,4,3,3,10,Silver
1863,1882,10,73,165351,1,2,2,5,Platinum
1864,1883,86,23,78571,3,3,3,9,Silver
1865,1884,8,498,1354042,1,1,1,3,Platinum
1866,1885,206,43,62817,4,2,3,9,Silver
1867,1886,8,55,157640,1,2,2,5,Platinum
1868,1887,24,116,184888,2,1,2,5,Platinum
1869,1888,12,96,169733,1,2,2,5,Platinum
1870,1889,26,20,46762,2,3,3,8,Gold
1871,1890,22,355,364076,2,1,1,4,Platinum
1872,1891,3,69,205535,1,2,2,5,Platinum
1873,1892,159,17,73989,4,4,3,11,Bronze
1874,1893,4,165,429177,1,1,1,3,Platinum
1875,1894,75,9,33220,3,4,4,11,Bronze
1876,1895,5,30,52460,1,3,3,7,Gold
1877,1896,2,5674,18148261,1,1,1,3,Platinum
1878,1897,18,27,137310,1,3,2,6,Gold
1879,1898,36,87,203156,2,2,2,6,Gold
1880,1899,96,12,36440,3,4,4,11,Bronze
1881,1900,71,77,183608,3,2,2,7,Gold
1882,1901,116,45,200035,3,2,2,7,Gold
1883,1902,213,57,127024,4,2,2,8,Gold
1884,1903,31,78,184820,2,2,2,6,Gold
1885,1904,51,44,100311,2,2,2,6,Gold
1886,1905,247,10,35083,4,4,4,12,Bronze
1887,1906,33,11,30142,2,4,4,10,Silver
1888,1907,109,128,299868,3,1,1,5,Platinum
1889,1908,5,40,116239,1,3,2,6,Gold
1890,1909,366,17,40694,4,4,3,11,Bronze
1891,1910,82,87,242839,3,2,1,6,Gold
1892,1911,298,10,237285,4,4,1,9,Silver
1893,1912,34,364,1015948,2,1,1,4,Platinum
1894,1913,57,34,182344,3,3,2,8,Gold
1895,1914,30,170,720314,2,1,1,4,Platinum
1896,1915,17,3,11822,1,4,4,9,Silver
1897,1916,79,14,37871,3,4,4,11,Bronze
1898,1917,24,63,148079,2,2,2,6,Gold
1899,1918,20,19,43892,2,3,3,8,Gold
1900,1919,81,20,44123,3,3,3,9,Silver
1901,1920,60,138,983121,3,1,1,5,Platinum
1902,1921,26,55,39827,2,2,3,7,Gold
1903,1922,13,85,40285,1,2,3,6,Gold
1904,1923,254,12,8192,4,4,4,12,Bronze
1905,1924,148,42,55050,4,2,3,9,Silver
1906,1925,66,59,92390,3,2,2,7,Gold
1907,1926,9,27,35091,1,3,4,8,Gold
1908,1927,11,312,890457,1,1,1,3,Platinum
1909,1928,275,5,14892,4,4,4,12,Bronze
1910,1929,10,198,197688,1,1,2,4,Platinum
1911,1930,250,13,30522,4,4,4,12,Bronze
1912,1931,97,83,77772,3,2,3,8,Gold
1913,1932,15,38,28734,1,3,4,8,Gold
1914,1933,50,6,51724,2,4,3,9,Silver
1915,1934,31,37,20005,2,3,4,9,Silver
1916,1935,69,34,170536,3,3,2,8,Gold
1917,1936,36,160,141602,2,1,2,5,Platinum
1918,1937,129,18,12656,3,3,4,10,Silver
1919,1938,111,32,145021,3,3,2,8,Gold
1920,1939,38,21,13343,2,3,4,9,Silver
1921,1940,58,11,44453,3,4,3,10,Silver
1922,1941,58,70,88638,3,2,2,7,Gold
1923,1942,73,216,221921,3,1,1,5,Platinum
1924,1943,247,8,14037,4,4,4,12,Bronze
1925,1944,20,41,24536,2,3,4,9,Silver
1926,1945,199,87,44037,4,2,3,9,Silver
1927,1946,16,4,39520,1,4,3,8,Gold
1928,1947,212,40,38888,4,3,4,11,Bronze
1929,1948,39,61,28207,2,2,4,8,Gold
1930,1949,47,26,98316,2,3,2,7,Gold
1931,1950,171,75,57030,4,2,3,9,Silver
1932,1951,48,77,61836,2,2,3,7,Gold
1933,1952,116,115,207117,3,1,2,6,Gold
1934,1953,148,157,154257,4,1,2,7,Gold
1935,1954,16,1118,844492,1,1,1,3,Platinum
1936,1955,52,143,64325,2,1,3,6,Gold
1937,1956,160,12,19567,4,4,4,12,Bronze
1938,1957,13,182,156327,1,1,2,4,Platinum
1939,1958,36,20,41673,2,3,3,8,Gold
1940,1959,54,128,53611,3,1,3,7,Gold
1941,1960,44,35,31470,2,3,4,9,Silver
1942,1961,173,20,20341,4,3,4,11,Bronze
1943,1962,34,20,16507,2,3,4,9,Silver
1944,1963,39,31,56953,2,3,3,8,Gold
1945,1964,267,70,34324,4,2,4,10,Silver
1946,1965,9,472,235555,1,1,1,3,Platinum
1947,1966,12,135,117642,1,1,2,4,Platinum
1948,1967,4,560,822436,1,1,1,3,Platinum
1949,1968,10,155,214095,1,1,1,3,Platinum
1950,1969,34,72,47060,2,2,3,7,Gold
1951,1970,81,60,57100,3,2,3,8,Gold
1952,1971,35,35,125710,2,3,2,7,Gold
1953,1972,12,48,83653,1,2,3,6,Gold
1954,1973,74,7,67824,3,4,3,10,Silver
1955,1974,5,111,89927,1,1,2,4,Platinum
1956,1975,257,52,640764,4,2,1,7,Gold
1957,1976,5,509,340663,1,1,1,3,Platinum
1958,1977,16,394,568742,1,1,1,3,Platinum
1959,1978,90,27,41792,3,3,3,9,Silver
1960,1979,73,127,64809,3,1,3,7,Gold
1961,1980,66,130,81597,3,1,3,7,Gold
1962,1981,10,1502,2461554,1,1,1,3,Platinum
1963,1982,171,67,23409,4,2,4,10,Silver
1964,1983,202,5,14862,4,4,4,12,Bronze
1965,1984,32,3,69200,2,4,3,9,Silver
1966,1985,20,453,914560,2,1,1,4,Platinum
1967,1986,152,12,79400,4,4,3,11,Bronze
1968,1987,11,205,691786,1,1,1,3,Platinum
1969,1988,270,22,47916,4,3,3,10,Silver
1970,1989,66,97,49115,3,2,3,8,Gold
1971,1990,279,3,16431,4,4,4,12,Bronze
1972,1991,26,78,234694,2,2,1,5,Platinum
1973,1992,24,143,187430,2,1,2,5,Platinum
1974,1993,320,30,25828,4,3,4,11,Bronze
1975,1994,5,71,128920,1,2,2,5,Platinum
1976,1995,13,114,40923,1,1,3,5,Platinum
1977,1996,281,25,183502,4,3,2,9,Silver
1978,1997,26,276,272777,2,1,1,4,Platinum
1979,1998,41,237,163560,2,1,2,5,Platinum
1980,1999,9,120,44703,1,1,3,5,Platinum
1981,2000,5,397,5953371,1,1,1,3,Platinum
1982,2001,73,57,142597,3,2,2,7,Gold
1983,2002,214,5,38566,4,4,4,12,Bronze
1984,2003,38,155,387539,2,1,1,4,Platinum
1985,2004,54,42,104207,3,2,2,7,Gold
1986,2005,79,82,221706,3,2,1,6,Gold
1987,2006,47,104,72328,2,1,3,6,Gold
1988,2007,180,70,132737,4,2,2,8,Gold
1989,2008,376,1,12024,4,4,4,12,Bronze
1990,2009,95,26,107303,3,3,2,8,Gold
1991,2010,11,54,127071,1,2,2,5,Platinum
1992,2011,106,42,93575,3,2,2,7,Gold
1993,2012,78,27,101787,3,3,2,8,Gold
1994,2013,173,49,114768,4,2,2,8,Gold
1995,2014,8,440,1244884,1,1,1,3,Platinum
1996,2015,213,47,106884,4,2,2,8,Gold
1997,2016,25,33,58267,2,3,3,8,Gold
1998,2017,259,5,11792,4,4,4,12,Bronze
1999,2018,282,15,61264,4,4,3,11,Bronze
2000,2019,22,57,140535,2,2,2,6,Gold
2001,2020,11,145,316242,1,1,1,3,Platinum
2002,2021,310,23,49854,4,3,3,10,Silver
2003,2022,68,30,66679,3,3,3,9,Silver
2004,2023,216,26,51421,4,3,3,10,Silver
2005,2024,19,108,662409,1,1,1,3,Platinum
2006,2025,104,47,195487,3,2,2,7,Gold
2007,2026,43,11,25253,2,4,4,10,Silver
2008,2027,5,25,31944,1,3,4,8,Gold
2009,2028,183,2,95933,4,4,2,10,Silver
2010,2029,85,23,63861,3,3,3,9,Silver
2011,2030,343,3,93264,4,4,2,10,Silver
2012,2031,12,8,36575,1,4,4,9,Silver
2013,2032,32,35,84481,2,3,3,8,Gold
2014,2033,197,69,130605,4,2,2,8,Gold
2015,2034,20,101,290909,2,1,1,4,Platinum
2016,2035,18,100,199819,1,2,2,5,Platinum
2017,2036,315,17,40728,4,4,3,11,Bronze
2018,2037,142,57,141510,3,2,2,7,Gold
2019,2038,246,28,55372,4,3,3,10,Silver
2020,2039,24,35,110555,2,3,2,7,Gold
2021,2040,30,84,192510,2,2,2,6,Gold
2022,2041,10,99,479590,1,2,1,4,Platinum
2023,2042,31,197,441490,2,1,1,4,Platinum
2024,2043,19,21,40498,1,3,3,7,Gold
2025,2044,18,45,167741,1,2,2,5,Platinum
2026,2045,15,79,244094,1,2,1,4,Platinum
2027,2047,246,14,30596,4,4,4,12,Bronze
2028,2048,134,21,50252,3,3,3,9,Silver
2029,2049,51,28,58497,2,3,3,8,Gold
2030,2050,115,82,203298,3,2,2,7,Gold
2031,2051,8,106,283757,1,1,1,3,Platinum
2032,2052,23,15,29692,2,4,4,10,Silver
2033,2053,27,127,1445062,2,1,1,4,Platinum
2034,2054,67,16,53359,3,4,3,10,Silver
2035,2055,61,102,213247,3,1,1,5,Platinum
2036,2056,51,84,427231,2,2,1,5,Platinum
2037,2057,170,22,39328,4,3,3,10,Silver
2038,2058,26,52,129380,2,2,2,6,Gold
2039,2059,128,29,125874,3,3,2,8,Gold
2040,2060,16,73,187540,1,2,2,5,Platinum
2041,2061,241,9,16053,4,4,4,12,Bronze
2042,2062,4,68,167603,1,2,2,5,Platinum
2043,2063,242,13,27166,4,4,4,12,Bronze
2044,2064,53,80,325163,3,2,1,6,Gold
2045,2065,47,26,71144,2,3,3,8,Gold
2046,2066,226,14,32266,4,4,4,12,Bronze
2047,2067,9,217,811774,1,1,1,3,Platinum
2048,2068,9,67,154054,1,2,2,5,Platinum
2049,2069,165,91,199482,4,2,2,8,Gold
2050,2070,241,28,78932,4,3,3,10,Silver
2051,2071,12,20,36985,1,3,4,8,Gold
2052,2072,134,23,57265,3,3,3,9,Silver
2053,2073,18,343,733153,1,1,1,3,Platinum
2054,2074,10,271,608674,1,1,1,3,Platinum
2055,2075,32,22,41338,2,3,3,8,Gold
2056,2076,76,85,34584,3,2,4,9,Silver
2057,2077,3,55,125270,1,2,2,5,Platinum
2058,2078,4,125,311180,1,1,1,3,Platinum
2059,2079,47,7,51942,2,4,3,9,Silver
2060,2080,4,710,2450131,1,1,1,3,Platinum
2061,2081,360,4,18108,4,4,4,12,Bronze
2062,2082,20,29,38187,2,3,4,9,Silver
2063,2083,69,103,101362,3,1,2,6,Gold
2064,2084,374,27,56256,4,3,3,10,Silver
2065,2085,321,41,20384,4,3,4,11,Bronze
2066,2086,32,5,11940,2,4,4,10,Silver
2067,2087,335,5,142420,4,4,2,10,Silver
2068,2088,9,110,238890,1,1,1,3,Platinum
2069,2089,323,11,21408,4,4,4,12,Bronze
2070,2090,72,23,40918,3,3,3,9,Silver
2071,2091,262,3,6010,4,4,4,12,Bronze
2072,2092,19,93,323096,1,2,1,4,Platinum
2073,2093,369,6,10863,4,4,4,12,Bronze
2074,2094,67,16,91560,3,4,2,9,Silver
2075,2095,155,29,75781,4,3,3,10,Silver
2076,2096,30,63,50620,2,2,3,7,Gold
2077,2097,71,21,57750,3,3,3,9,Silver
2078,2098,17,19,49221,1,3,3,7,Gold
2079,2099,5,90,565004,1,2,1,4,Platinum
2080,2100,3,212,1915993,1,1,1,3,Platinum
2081,2101,120,51,152555,3,2,2,7,Gold
2082,2102,62,19,58743,3,3,3,9,Silver
2083,2103,4,310,1064349,1,1,1,3,Platinum
2084,2105,11,32,132565,1,3,2,6,Gold
2085,2106,93,10,25048,3,4,4,11,Bronze
2086,2107,64,13,137620,3,4,2,9,Silver
2087,2108,88,69,187234,3,2,2,7,Gold
2088,2109,26,142,274224,2,1,1,4,Platinum
2089,2110,359,9,49972,4,4,3,11,Bronze
2090,2111,86,37,85857,3,3,3,9,Silver
2091,2112,17,9,47454,1,4,3,8,Gold
2092,2113,2,42,102479,1,2,2,5,Platinum
2093,2114,226,20,43800,4,3,3,10,Silver
2094,2115,61,52,101157,3,2,2,7,Gold
2095,2116,242,5,12674,4,4,4,12,Bronze
2096,2117,324,24,49987,4,3,3,10,Silver
2097,2118,2,110,225525,1,1,1,3,Platinum
2098,2119,47,35,83914,2,3,3,8,Gold
2099,2120,93,2,11076,3,4,4,11,Bronze
2100,2121,11,166,759560,1,1,1,3,Platinum
2101,2122,177,9,32461,4,4,4,12,Bronze
2102,2123,52,117,253841,2,1,1,4,Platinum
2103,2124,368,5,41770,4,4,3,11,Bronze
2104,2125,319,5,75720,4,4,3,11,Bronze
2105,2126,226,20,82988,4,3,3,10,Silver
2106,2127,360,14,39637,4,4,3,11,Bronze
2107,2128,235,23,51112,4,3,3,10,Silver
2108,2129,311,8,17941,4,4,4,12,Bronze
2109,2130,37,58,154037,2,2,2,6,Gold
2110,2131,67,125,466070,3,1,1,5,Platinum
2111,2132,241,23,63678,4,3,3,10,Silver
2112,2133,114,31,91496,3,3,2,8,Gold
2113,2134,277,14,31338,4,4,4,12,Bronze
2114,2135,218,143,291750,4,1,1,6,Gold
2115,2136,299,15,45703,4,4,3,11,Bronze
2116,2137,2,99,196073,1,2,2,5,Platinum
2117,2138,32,50,144318,2,2,2,6,Gold
2118,2139,11,49,106240,1,2,2,5,Platinum
2119,2140,45,78,232038,2,2,1,5,Platinum
2120,2141,67,110,274214,3,1,1,5,Platinum
2121,2142,75,22,41500,3,3,3,9,Silver
2122,2143,67,34,79134,3,3,3,9,Silver
2123,2144,135,89,339225,3,2,1,6,Gold
2124,2145,239,33,65006,4,3,3,10,Silver
2125,2146,125,6,43088,3,4,3,10,Silver
2126,2147,32,350,840900,2,1,1,4,Platinum
2127,2148,10,111,1374487,1,1,1,3,Platinum
2128,2149,37,44,99580,2,2,2,6,Gold
2129,2150,17,53,134858,1,2,2,5,Platinum
2130,2151,128,18,45303,3,3,3,9,Silver
2131,2152,67,47,115487,3,2,2,7,Gold
2132,2153,149,6,11513,4,4,4,12,Bronze
2133,2154,284,7,33756,4,4,4,12,Bronze
2134,2155,169,34,69124,4,3,3,10,Silver
2135,2156,101,77,224040,3,2,1,6,Gold
2136,2157,136,19,38316,3,3,4,10,Silver
2137,2158,324,10,21688,4,4,4,12,Bronze
2138,2159,107,12,20580,3,4,4,11,Bronze
2139,2160,65,23,53042,3,3,3,9,Silver
2140,2161,152,82,184196,4,2,2,8,Gold
2141,2162,343,6,12736,4,4,4,12,Bronze
2142,2163,29,11,206936,2,4,2,8,Gold
2143,2164,24,2,43306,2,4,3,9,Silver
2144,2165,18,41,307201,1,3,1,5,Platinum
2145,2166,9,274,315032,1,1,1,3,Platinum
2146,2167,58,63,90357,3,2,2,7,Gold
2147,2168,5,47,104517,1,2,2,5,Platinum
2148,2169,38,41,84316,2,3,3,8,Gold
2149,2170,67,52,17100,3,2,4,9,Silver
2150,2171,47,12,38679,2,4,4,10,Silver
2151,2172,355,19,42702,4,3,3,10,Silver
2152,2173,173,16,17533,4,4,4,12,Bronze
2153,2174,60,139,299601,3,1,1,5,Platinum
2154,2175,52,3,25542,2,4,4,10,Silver
2155,2176,23,20,71014,2,3,3,8,Gold
2156,2177,44,88,267623,2,2,1,5,Platinum
2157,2178,31,58,146829,2,2,2,6,Gold
2158,2179,5,204,1047591,1,1,1,3,Platinum
2159,2180,26,102,560456,2,1,1,4,Platinum
2160,2181,202,25,21961,4,3,4,11,Bronze
2161,2182,51,194,458969,2,1,1,4,Platinum
2162,2183,11,39,78614,1,3,3,7,Gold
2163,2184,3,191,529689,1,1,1,3,Platinum
2164,2185,70,4,250917,3,4,1,8,Gold
2165,2186,65,28,64828,3,3,3,9,Silver
2166,2187,51,243,652637,2,1,1,4,Platinum
2167,2188,291,31,68949,4,3,3,10,Silver
2168,2189,61,23,74482,3,3,3,9,Silver
2169,2190,65,58,158855,3,2,2,7,Gold
2170,2191,96,12,22403,3,4,4,11,Bronze
2171,2192,275,19,40151,4,3,3,10,Silver
2172,2193,1,2379,8077245,1,1,1,3,Platinum
2173,2194,77,47,114118,3,2,2,7,Gold
2174,2195,111,1,6800,3,4,4,11,Bronze
2175,2196,200,24,46634,4,3,3,10,Silver
2176,2197,65,37,100526,3,3,2,8,Gold
2177,2198,327,1,26300,4,4,4,12,Bronze
2178,2199,4,33,69752,1,3,3,7,Gold
2179,2200,284,16,29493,4,4,4,12,Bronze
2180,2201,45,36,43453,2,3,3,8,Gold
2181,2202,71,95,333721,3,2,1,6,Gold
2182,2203,86,42,91296,3,2,2,7,Gold
2183,2204,104,49,27496,3,2,4,9,Silver
2184,2205,334,29,54538,4,3,3,10,Silver
2185,2206,53,10,27119,3,4,4,11,Bronze
2186,2207,40,57,128821,2,2,2,6,Gold
2187,2208,33,13,110944,2,4,2,8,Gold
2188,2209,370,35,202432,4,3,2,9,Silver
2189,2210,209,16,122592,4,4,2,10,Silver
2190,2211,157,98,49240,4,2,3,9,Silver
2191,2212,54,36,20656,3,3,4,10,Silver
2192,2213,67,86,78927,3,2,3,8,Gold
2193,2214,81,17,247144,3,4,1,8,Gold
2194,2215,131,24,55733,3,3,3,9,Silver
2195,2216,88,21,40730,3,3,3,9,Silver
2196,2217,7,26,62094,1,3,3,7,Gold
2197,2218,46,20,43250,2,3,3,8,Gold
2198,2219,333,17,31193,4,4,4,12,Bronze
2199,2220,371,5,29064,4,4,4,12,Bronze
2200,2221,74,9,20400,3,4,4,11,Bronze
2201,2222,159,72,62239,4,2,3,9,Silver
2202,2223,378,5,14670,4,4,4,12,Bronze
2203,2224,13,225,234901,1,1,1,3,Platinum
2204,2225,255,63,95772,4,2,2,8,Gold
2205,2226,30,14,30164,2,4,4,10,Silver
2206,2227,32,519,356880,2,1,1,4,Platinum
2207,2228,5,551,1200418,1,1,1,3,Platinum
2208,2229,40,13,51670,2,4,3,9,Silver
2209,2230,362,7,62856,4,4,3,11,Bronze
2210,2231,373,16,43021,4,4,3,11,Bronze
2211,2232,96,29,112334,3,3,2,8,Gold
2212,2233,26,114,288559,2,1,1,4,Platinum
2213,2234,76,44,85528,3,2,3,8,Gold
2214,2235,58,95,236909,3,2,1,6,Gold
2215,2236,22,4,52590,2,4,3,9,Silver
2216,2238,46,94,284987,2,2,1,5,Platinum
2217,2239,138,27,323508,3,3,1,7,Gold
2218,2240,9,132,267090,1,1,1,3,Platinum
2219,2241,132,3,17754,3,4,4,11,Bronze
2220,2242,41,117,156727,2,1,2,5,Platinum
2221,2243,171,194,481453,4,1,1,6,Gold
2222,2244,10,36,189946,1,3,2,6,Gold
2223,2245,220,8,69639,4,4,3,11,Bronze
2224,2246,15,302,797479,1,1,1,3,Platinum
2225,2247,170,41,87485,4,3,2,9,Silver
2226,2248,41,12,42184,2,4,3,9,Silver
2227,2249,187,31,58259,4,3,3,10,Silver
2228,2250,271,10,17052,4,4,4,12,Bronze
2229,2251,181,1,61600,4,4,3,11,Bronze
2230,2252,6,84,213009,1,2,1,4,Platinum
2231,2253,18,12,32352,1,4,4,9,Silver
2232,2254,10,85,257398,1,2,1,4,Platinum
2233,2255,326,7,11703,4,4,4,12,Bronze
2234,2256,113,14,35212,3,4,4,11,Bronze
2235,2257,291,6,10554,4,4,4,12,Bronze
2236,2258,17,73,171364,1,2,2,5,Platinum
2237,2259,2,50,112756,1,2,2,5,Platinum
2238,2260,96,12,90784,3,4,2,9,Silver
2239,2261,150,41,100352,4,3,2,9,Silver
2240,2262,193,8,47675,4,4,3,11,Bronze
2241,2263,33,53,63803,2,2,3,7,Gold
2242,2264,34,153,139261,2,1,2,5,Platinum
2243,2265,265,34,33300,4,3,4,11,Bronze
2244,2266,85,122,406604,3,1,1,5,Platinum
2245,2267,27,99,163068,2,2,2,6,Gold
2246,2268,173,10,25753,4,4,4,12,Bronze
2247,2269,10,39,95922,1,3,2,6,Gold
2248,2270,314,48,82235,4,2,3,9,Silver
2249,2271,65,192,506797,3,1,1,5,Platinum
2250,2272,86,28,66466,3,3,3,9,Silver
2251,2273,25,8,22032,2,4,4,10,Silver
2252,2274,59,53,123053,3,2,2,7,Gold
2253,2275,328,6,12466,4,4,4,12,Bronze
2254,2276,47,2,11010,2,4,4,10,Silver
2255,2277,255,17,52658,4,4,3,11,Bronze
2256,2278,20,292,175337,2,1,2,5,Platinum
2257,2279,34,306,205931,2,1,2,5,Platinum
2258,2280,21,6,17184,2,4,4,10,Silver
2259,2281,27,82,62889,2,2,3,7,Gold
2260,2282,24,10,20764,2,4,4,10,Silver
2261,2283,214,41,80441,4,3,3,10,Silver
2262,2284,9,55,138567,1,2,2,5,Platinum
2263,2285,23,29,17200,2,3,4,9,Silver
2264,2286,13,329,143512,1,1,2,4,Platinum
2265,2287,263,45,24069,4,2,4,10,Silver
2266,2288,132,25,18738,3,3,4,10,Silver
2267,2289,55,62,47785,3,2,3,8,Gold
2268,2290,257,2,68880,4,4,3,11,Bronze
2269,2291,2,382,401137,1,1,1,3,Platinum
2270,2292,10,219,181903,1,1,2,4,Platinum
2271,2293,267,5,14178,4,4,4,12,Bronze
2272,2294,331,9,20334,4,4,4,12,Bronze
2273,2295,313,28,62108,4,3,3,10,Silver
2274,2296,27,60,135097,2,2,2,6,Gold
2275,2297,31,30,57288,2,3,3,8,Gold
2276,2298,30,58,67546,2,2,3,7,Gold
2277,2299,2,286,181786,1,1,2,4,Platinum
2278,2300,363,25,21555,4,3,4,11,Bronze
2279,2301,284,60,70556,4,2,3,9,Silver
2280,2302,264,58,31093,4,2,4,10,Silver
2281,2303,26,7,20568,2,4,4,10,Silver
2282,2304,355,58,25490,4,2,4,10,Silver
2283,2305,95,11,30704,3,4,4,11,Bronze
2284,2306,32,7,16688,2,4,4,10,Silver
2285,2307,339,157,121930,4,1,2,7,Gold
2286,2308,20,97,788858,2,2,1,5,Platinum
2287,2309,86,57,46159,3,2,3,8,Gold
2288,2310,10,52,67643,1,2,3,6,Gold
2289,2311,53,24,52462,3,3,3,9,Silver
2290,2312,51,24,59756,2,3,3,8,Gold
2291,2313,3,77,60284,1,2,3,6,Gold
2292,2314,114,76,49529,3,2,3,8,Gold
2293,2315,17,11,223736,1,4,1,6,Gold
2294,2316,78,29,61131,3,3,3,9,Silver
2295,2317,41,46,173937,2,2,2,6,Gold
2296,2318,117,45,106810,3,2,2,7,Gold
2297,2319,16,97,1332788,1,2,1,4,Platinum
2298,2320,162,88,41207,4,2,3,9,Silver
2299,2321,2,188,522497,1,1,1,3,Platinum
2300,2322,31,86,323168,2,2,1,5,Platinum
2301,2323,102,2,10728,3,4,4,11,Bronze
2302,2324,25,50,144559,2,2,2,6,Gold
2303,2325,96,154,391352,3,1,1,5,Platinum
2304,2326,30,35,95370,2,3,2,7,Gold
2305,2327,33,297,228333,2,1,1,4,Platinum
2306,2328,22,125,189528,2,1,2,5,Platinum
2307,2329,18,15,158744,1,4,2,7,Gold
2308,2330,3,512,1622728,1,1,1,3,Platinum
2309,2331,10,68,142643,1,2,2,5,Platinum
2310,2332,16,209,929772,1,1,1,3,Platinum
2311,2333,363,70,18190,4,2,4,10,Silver
2312,2334,82,13,6892,3,4,4,11,Bronze
2313,2335,53,97,493442,3,2,1,6,Gold
2314,2336,23,164,142793,2,1,2,5,Platinum
2315,2337,172,46,57368,4,2,3,9,Silver
2316,2338,190,92,124658,4,2,2,8,Gold
2317,2339,333,1,25082,4,4,4,12,Bronze
2318,2340,12,160,106323,1,1,2,4,Platinum
2319,2341,157,7,16342,4,4,4,12,Bronze
2320,2342,35,308,1774412,2,1,1,4,Platinum
2321,2343,15,178,521230,1,1,1,3,Platinum
2322,2344,45,15,7921,2,4,4,10,Silver
2323,2345,234,27,41934,4,3,3,10,Silver
2324,2346,65,214,259880,3,1,1,5,Platinum
2325,2347,2,18,50286,1,3,3,7,Gold
2326,2348,41,185,392367,2,1,1,4,Platinum
2327,2349,33,57,76204,2,2,3,7,Gold
2328,2350,85,10,47020,3,4,3,10,Silver
2329,2351,25,1,44112,2,4,3,9,Silver
2330,2352,3,177,102373,1,1,2,4,Platinum
2331,2353,36,4,15938,2,4,4,10,Silver
2332,2354,19,163,293043,1,1,1,3,Platinum
2333,2355,255,26,31213,4,3,4,11,Bronze
2334,2356,23,671,580213,2,1,1,4,Platinum
2335,2357,22,108,195167,2,1,2,5,Platinum
2336,2358,9,228,251913,1,1,1,3,Platinum
2337,2359,26,255,183943,2,1,2,5,Platinum
2338,2360,20,83,93863,2,2,2,6,Gold
2339,2361,174,75,62341,4,2,3,9,Silver
2340,2362,164,24,12304,4,3,4,11,Bronze
2341,2363,8,41,75117,1,3,3,7,Gold
2342,2364,12,15,33451,1,4,4,9,Silver
2343,2365,115,29,11195,3,3,4,10,Silver
2344,2366,289,28,16815,4,3,4,11,Bronze
2345,2367,10,259,502504,1,1,1,3,Platinum
2346,2368,55,81,36147,3,2,4,9,Silver
2347,2369,8,702,685901,1,1,1,3,Platinum
2348,2370,78,114,196729,3,1,2,6,Gold
2349,2371,5,61,71404,1,2,3,6,Gold
2350,2372,37,29,55464,2,3,3,8,Gold
2351,2373,218,17,11419,4,4,4,12,Bronze
2352,2374,61,56,70597,3,2,3,8,Gold
2353,2375,279,14,25982,4,4,4,12,Bronze
2354,2376,13,897,701797,1,1,1,3,Platinum
2355,2377,25,31,40596,2,3,3,8,Gold
2356,2378,29,20,57580,2,3,3,8,Gold
2357,2379,12,27,94188,1,3,2,6,Gold
2358,2380,357,1,14742,4,4,4,12,Bronze
2359,2381,23,111,215157,2,1,1,4,Platinum
2360,2382,53,8,21018,3,4,4,11,Bronze
2361,2383,20,7,28303,2,4,4,10,Silver
2362,2384,3,53,97695,1,2,2,5,Platinum
2363,2385,104,31,182235,3,3,2,8,Gold
2364,2386,11,323,520078,1,1,1,3,Platinum
2365,2387,16,57,78096,1,2,3,6,Gold
2366,2388,5,215,318817,1,1,1,3,Platinum
2367,2389,32,103,72413,2,1,3,6,Gold
2368,2390,178,168,85977,4,1,3,8,Gold
2369,2391,38,45,113185,2,2,2,6,Gold
2370,2392,152,39,30638,4,3,4,11,Bronze
2371,2393,163,13,14765,4,4,4,12,Bronze
2372,2394,70,51,40660,3,2,3,8,Gold
2373,2395,157,146,87878,4,1,2,7,Gold
2374,2396,28,44,91714,2,2,2,6,Gold
2375,2397,24,123,89835,2,1,2,5,Platinum
2376,2398,177,31,61487,4,3,3,10,Silver
2377,2399,56,9,109452,3,4,2,9,Silver
2378,2400,256,29,57519,4,3,3,10,Silver
2379,2402,47,24,57286,2,3,3,8,Gold
2380,2403,72,5,24156,3,4,4,11,Bronze
2381,2404,17,103,229419,1,1,1,3,Platinum
2382,2405,107,77,168103,3,2,2,7,Gold
2383,2406,36,22,45279,2,3,3,8,Gold
2384,2407,54,14,32484,3,4,4,11,Bronze
2385,2408,28,52,108378,2,2,2,6,Gold
2386,2409,13,410,929375,1,1,1,3,Platinum
2387,2410,9,47,191711,1,2,2,5,Platinum
2388,2411,87,2,8160,3,4,4,11,Bronze
2389,2412,53,17,29769,3,4,4,11,Bronze
2390,2413,37,67,144739,2,2,2,6,Gold
2391,2414,63,77,345653,3,2,1,6,Gold
2392,2415,339,13,18096,4,4,4,12,Bronze
2393,2416,31,60,145080,2,2,2,6,Gold
2394,2417,186,16,37660,4,4,4,12,Bronze
2395,2418,53,6,15752,3,4,4,11,Bronze
2396,2419,11,41,189274,1,3,2,6,Gold
2397,2420,44,6,21939,2,4,4,10,Silver
2398,2421,11,423,1311867,1,1,1,3,Platinum
2399,2422,33,44,99581,2,2,2,6,Gold
2400,2423,12,3,41200,1,4,3,8,Gold
2401,2424,57,100,208483,3,2,2,7,Gold
2402,2425,5,16,155064,1,4,2,7,Gold
2403,2426,44,185,452780,2,1,1,4,Platinum
2404,2427,142,19,35918,3,3,4,10,Silver
2405,2428,117,34,72195,3,3,3,9,Silver
2406,2429,106,64,210792,3,2,2,7,Gold
2407,2430,75,49,112418,3,2,2,7,Gold
2408,2431,5,155,378389,1,1,1,3,Platinum
2409,2432,46,60,157868,2,2,2,6,Gold
2410,2433,16,167,441340,1,1,1,3,Platinum
2411,2434,18,15,28891,1,4,4,9,Silver
2412,2435,90,25,90636,3,3,2,8,Gold
2413,2436,53,15,30040,3,4,4,11,Bronze
2414,2438,136,25,57991,3,3,3,9,Silver
2415,2439,5,484,1561909,1,1,1,3,Platinum
2416,2440,107,119,270975,3,1,1,5,Platinum
2417,2441,193,33,76289,4,3,3,10,Silver
2418,2442,167,238,108545,4,1,2,7,Gold
2419,2443,19,51,73419,1,2,3,6,Gold
2420,2444,161,35,61911,4,3,3,10,Silver
2421,2445,205,25,75149,4,3,3,10,Silver
2422,2446,343,2,88440,4,4,2,10,Silver
2423,2447,37,32,86186,2,3,2,7,Gold
2424,2448,92,21,43839,3,3,3,9,Silver
2425,2449,94,6,155976,3,4,2,9,Silver
2426,2450,10,21,114576,1,3,2,6,Gold
2427,2451,244,34,74112,4,3,3,10,Silver
2428,2452,46,47,93001,2,2,2,6,Gold
2429,2453,26,1,5160,2,4,4,10,Silver
2430,2454,197,48,113133,4,2,2,8,Gold
2431,2455,44,11,35815,2,4,4,10,Silver
2432,2456,27,90,206775,2,2,2,6,Gold
2433,2457,321,5,45748,4,4,3,11,Bronze
2434,2458,107,9,20422,3,4,4,11,Bronze
2435,2459,51,17,47165,2,4,3,9,Silver
2436,2460,169,116,303601,4,1,1,6,Gold
2437,2461,40,13,39048,2,4,4,10,Silver
2438,2462,220,1,13968,4,4,4,12,Bronze
2439,2463,41,33,86080,2,3,3,8,Gold
2440,2464,297,12,21026,4,4,4,12,Bronze
2441,2465,22,78,336963,2,2,1,5,Platinum
2442,2466,89,155,367569,3,1,1,5,Platinum
2443,2467,74,113,281609,3,1,1,5,Platinum
2444,2468,82,21,58733,3,3,3,9,Silver
2445,2469,21,202,463589,2,1,1,4,Platinum
2446,2470,50,33,84261,2,3,3,8,Gold
2447,2471,53,12,46356,3,4,3,10,Silver
2448,2472,27,110,142836,2,1,2,5,Platinum
2449,2473,10,78,182134,1,2,2,5,Platinum
2450,2474,26,53,179010,2,2,2,6,Gold
2451,2475,119,10,26987,3,4,4,11,Bronze
2452,2476,9,166,362501,1,1,1,3,Platinum
2453,2477,121,9,29186,3,4,4,11,Bronze
2454,2478,5,19,40776,1,3,3,7,Gold
2455,2479,255,2,15372,4,4,4,12,Bronze
2456,2480,29,12,26994,2,4,4,10,Silver
2457,2481,1,77,725142,1,2,1,4,Platinum
2458,2482,267,22,51802,4,3,3,10,Silver
2459,2483,34,171,321165,2,1,1,4,Platinum
2460,2484,18,18,37754,1,3,4,8,Gold
2461,2485,174,86,88179,4,2,2,8,Gold
2462,2486,3,237,200480,1,1,2,4,Platinum
2463,2487,266,5,24768,4,4,4,12,Bronze
2464,2488,141,117,280591,3,1,1,5,Platinum
2465,2489,203,6,18864,4,4,4,12,Bronze
2466,2490,68,55,118567,3,2,2,7,Gold
2467,2491,36,214,124914,2,1,2,5,Platinum
2468,2492,41,288,400889,2,1,1,4,Platinum
2469,2493,287,6,20033,4,4,4,12,Bronze
2470,2494,10,53,127475,1,2,2,5,Platinum
2471,2495,144,19,41309,4,3,3,10,Silver
2472,2496,12,35,41596,1,3,3,7,Gold
2473,2497,146,118,158934,4,1,2,7,Gold
2474,2498,239,7,19030,4,4,4,12,Bronze
2475,2499,33,936,643587,2,1,1,4,Platinum
2476,2500,25,128,75094,2,1,3,6,Gold
2477,2501,12,91,66637,1,2,3,6,Gold
2478,2502,37,69,261993,2,2,1,5,Platinum
2479,2503,365,41,24292,4,3,4,11,Bronze
2480,2504,203,11,26225,4,4,4,12,Bronze
2481,2505,16,32,52646,1,3,3,7,Gold
2482,2506,17,302,677311,1,1,1,3,Platinum
2483,2508,217,5,10284,4,4,4,12,Bronze
2484,2509,66,70,150389,3,2,2,7,Gold
2485,2510,214,14,40426,4,4,3,11,Bronze
2486,2511,283,10,18424,4,4,4,12,Bronze
2487,2512,115,26,152639,3,3,2,8,Gold
2488,2513,15,72,152723,1,2,2,5,Platinum
2489,2514,19,173,623721,1,1,1,3,Platinum
2490,2515,67,8,59680,3,4,3,10,Silver
2491,2516,51,9,23444,2,4,4,10,Silver
2492,2517,17,88,88210,1,2,2,5,Platinum
2493,2518,78,3,5376,3,4,4,11,Bronze
2494,2519,20,62,128363,2,2,2,6,Gold
2495,2520,135,28,28783,3,3,4,10,Silver
2496,2521,13,93,121126,1,2,2,5,Platinum
2497,2522,41,21,17550,2,3,4,9,Silver
2498,2524,3,293,333423,1,1,1,3,Platinum
2499,2525,40,411,366762,2,1,1,4,Platinum
2500,2526,311,1,13968,4,4,4,12,Bronze
2501,2527,52,28,55687,2,3,3,8,Gold
2502,2528,11,141,311309,1,1,1,3,Platinum
2503,2529,62,192,64540,3,1,3,7,Gold
2504,2530,66,45,95684,3,2,2,7,Gold
2505,2531,26,9,22333,2,4,4,10,Silver
2506,2532,220,7,28544,4,4,4,12,Bronze
2507,2533,66,37,70712,3,3,3,9,Silver
2508,2534,32,61,121569,2,2,2,6,Gold
2509,2535,92,180,422735,3,1,1,5,Platinum
2510,2536,65,11,39472,3,4,3,10,Silver
2511,2537,116,27,77629,3,3,3,9,Silver
2512,2538,13,114,5068622,1,1,1,3,Platinum
2513,2539,7,10,73949,1,4,3,8,Gold
2514,2540,69,25,31453,3,3,4,10,Silver
2515,2541,246,7,14120,4,4,4,12,Bronze
2516,2542,134,18,32798,3,3,4,10,Silver
2517,2543,243,21,122828,4,3,2,9,Silver
2518,2544,184,29,58423,4,3,3,10,Silver
2519,2545,28,20,43659,2,3,3,8,Gold
2520,2546,11,43,303411,1,2,1,4,Platinum
2521,2547,11,14,40134,1,4,3,8,Gold
2522,2548,33,83,314588,2,2,1,5,Platinum
2523,2549,47,267,674198,2,1,1,4,Platinum
2524,2550,27,206,123233,2,1,2,5,Platinum
2525,2551,359,25,57864,4,3,3,10,Silver
2526,2552,11,35,26199,1,3,4,8,Gold
2527,2553,44,75,195271,2,2,2,6,Gold
2528,2554,15,12,119689,1,4,2,7,Gold
2529,2555,150,42,86463,4,2,2,8,Gold
2530,2556,2,132,315048,1,1,1,3,Platinum
2531,2557,114,7,251328,3,4,1,8,Gold
2532,2558,76,98,137562,3,2,2,7,Gold
2533,2559,108,119,87156,3,1,2,6,Gold
2534,2560,47,64,134556,2,2,2,6,Gold
2535,2562,52,8,63054,2,4,3,9,Silver
2536,2563,2,263,553777,1,1,1,3,Platinum
2537,2564,24,301,724393,2,1,1,4,Platinum
2538,2565,47,31,110694,2,3,2,7,Gold
2539,2566,51,48,107534,2,2,2,6,Gold
2540,2567,307,208,437806,4,1,1,6,Gold
2541,2568,39,35,68759,2,3,3,8,Gold
2542,2569,86,89,183876,3,2,2,7,Gold
2543,2570,23,133,270330,2,1,1,4,Platinum
2544,2571,109,41,215951,3,3,1,7,Gold
2545,2572,208,40,164199,4,3,2,9,Silver
2546,2573,17,72,245574,1,2,1,4,Platinum
2547,2574,64,49,318572,3,2,1,6,Gold
2548,2575,50,123,256264,2,1,1,4,Platinum
2549,2576,320,17,25874,4,4,4,12,Bronze
2550,2577,45,62,67494,2,2,3,7,Gold
2551,2578,4,33,109130,1,3,2,6,Gold
2552,2580,173,20,64792,4,3,3,10,Silver
2553,2581,57,68,217176,3,2,1,6,Gold
2554,2582,74,115,226335,3,1,1,5,Platinum
2555,2583,100,51,106086,3,2,2,7,Gold
2556,2584,38,39,75793,2,3,3,8,Gold
2557,2585,59,68,141168,3,2,2,7,Gold
2558,2586,255,54,106292,4,2,2,8,Gold
2559,2587,71,272,274287,3,1,1,5,Platinum
2560,2588,46,50,117711,2,2,2,6,Gold
2561,2589,51,10,14773,2,4,4,10,Silver
2562,2590,65,24,47824,3,3,3,9,Silver
2563,2591,13,160,3244494,1,1,1,3,Platinum
2564,2592,34,62,140350,2,2,2,6,Gold
2565,2593,59,27,56355,3,3,3,9,Silver
2566,2594,73,47,170596,3,2,2,7,Gold
2567,2595,305,8,13631,4,4,4,12,Bronze
2568,2596,47,11,21384,2,4,4,10,Silver
2569,2597,18,138,466262,1,1,1,3,Platinum
2570,2598,39,22,49990,2,3,3,8,Gold
2571,2599,20,97,39319,2,2,3,7,Gold
2572,2600,190,22,19122,4,3,4,11,Bronze
2573,2601,52,30,18697,2,3,4,9,Silver
2574,2602,5,140,354165,1,1,1,3,Platinum
2575,2603,137,80,96442,3,2,2,7,Gold
2576,2604,5,644,2163929,1,1,1,3,Platinum
2577,2605,21,14,47738,2,4,3,9,Silver
2578,2606,16,191,202556,1,1,2,4,Platinum
2579,2607,41,141,121247,2,1,2,5,Platinum
2580,2608,13,546,446593,1,1,1,3,Platinum
2581,2609,9,147,111079,1,1,2,4,Platinum
2582,2610,26,18,7833,2,3,4,9,Silver
2583,2611,26,20,271764,2,3,1,6,Gold
2584,2612,41,40,104608,2,3,2,7,Gold
2585,2613,102,45,28855,3,2,4,9,Silver
2586,2614,6,459,483376,1,1,1,3,Platinum
2587,2615,278,15,23647,4,4,4,12,Bronze
2588,2616,33,76,53659,2,2,3,7,Gold
2589,2617,15,128,48652,1,1,3,5,Platinum
2590,2618,64,120,571835,3,1,1,5,Platinum
2591,2619,2,129,70474,1,1,3,5,Platinum
2592,2620,370,105,46595,4,1,3,8,Gold
2593,2621,313,29,61939,4,3,3,10,Silver
2594,2622,199,22,63996,4,3,3,10,Silver
2595,2623,3,49,50777,1,2,3,6,Gold
2596,2624,94,16,40134,3,4,3,10,Silver
2597,2625,61,12,25046,3,4,4,11,Bronze
2598,2626,82,10,20516,3,4,4,11,Bronze
2599,2627,157,91,52340,4,2,3,9,Silver
2600,2628,227,61,76084,4,2,3,9,Silver
2601,2629,254,40,33100,4,3,4,11,Bronze
2602,2630,150,11,22317,4,4,4,12,Bronze
2603,2631,195,24,30997,4,3,4,11,Bronze
2604,2632,2,86,168364,1,2,2,5,Platinum
2605,2633,369,4,8037,4,4,4,12,Bronze
2606,2634,24,51,46465,2,2,3,7,Gold
2607,2635,17,114,57860,1,1,3,5,Platinum
2608,2636,10,74,605628,1,2,1,4,Platinum
2609,2637,9,30,21842,1,3,4,8,Gold
2610,2638,20,150,183475,2,1,2,5,Platinum
2611,2639,4,248,121689,1,1,2,4,Platinum
2612,2640,174,7,21188,4,4,4,12,Bronze
2613,2641,1,267,173554,1,1,2,4,Platinum
2614,2642,179,19,32958,4,3,4,11,Bronze
2615,2643,17,155,193107,1,1,2,4,Platinum
2616,2644,248,12,13716,4,4,4,12,Bronze
2617,2645,192,40,40332,4,3,3,10,Silver
2618,2646,20,143,90570,2,1,2,5,Platinum
2619,2647,155,58,21906,4,2,4,10,Silver
2620,2648,173,25,41978,4,3,3,10,Silver
2621,2649,374,11,44328,4,4,3,11,Bronze
2622,2650,373,21,21015,4,3,4,11,Bronze
2623,2651,196,12,24747,4,4,4,12,Bronze
2624,2652,68,21,49673,3,3,3,9,Silver
2625,2653,5,115,376439,1,1,1,3,Platinum
2626,2654,22,74,159253,2,2,2,6,Gold
2627,2655,240,11,17226,4,4,4,12,Bronze
2628,2656,67,7,17513,3,4,4,11,Bronze
2629,2657,117,18,51188,3,3,3,9,Silver
2630,2658,93,76,849474,3,2,1,6,Gold
2631,2659,319,1,3708,4,4,4,12,Bronze
2632,2660,134,14,45716,3,4,3,10,Silver
2633,2661,277,6,35718,4,4,4,12,Bronze
2634,2662,367,2,19784,4,4,4,12,Bronze
2635,2663,83,29,217510,3,3,1,7,Gold
2636,2664,9,60,124346,1,2,2,5,Platinum
2637,2665,17,19,48880,1,3,3,7,Gold
2638,2666,32,98,212519,2,2,1,5,Platinum
2639,2667,9,41,89914,1,3,2,6,Gold
2640,2668,34,91,102097,2,2,2,6,Gold
2641,2669,17,98,213279,1,2,1,4,Platinum
2642,2670,26,183,553934,2,1,1,4,Platinum
2643,2671,32,42,53182,2,2,3,7,Gold
2644,2672,76,7,12342,3,4,4,11,Bronze
2645,2673,20,28,62196,2,3,3,8,Gold
2646,2674,18,122,106920,1,1,2,4,Platinum
2647,2675,24,84,52201,2,2,3,7,Gold
2648,2676,3,20,72178,1,3,3,7,Gold
2649,2677,304,11,37072,4,4,4,12,Bronze
2650,2678,22,34,499878,2,3,1,6,Gold
2651,2679,374,4,36870,4,4,4,12,Bronze
2652,2680,40,176,452258,2,1,1,4,Platinum
2653,2681,85,24,50685,3,3,3,9,Silver
2654,2682,166,98,57370,4,2,3,9,Silver
2655,2683,18,65,159927,1,2,2,5,Platinum
2656,2684,78,49,162358,3,2,2,7,Gold
2657,2685,90,43,325058,3,2,1,6,Gold
2658,2686,26,97,445292,2,2,1,5,Platinum
2659,2687,23,113,198502,2,1,2,5,Platinum
2660,2688,3,270,390211,1,1,1,3,Platinum
2661,2689,124,37,164242,3,3,2,8,Gold
2662,2690,31,14,29944,2,4,4,10,Silver
2663,2691,13,140,217497,1,1,1,3,Platinum
2664,2692,20,27,25210,2,3,4,9,Silver
2665,2693,45,52,100890,2,2,2,6,Gold
2666,2694,7,3,5044,1,4,4,9,Silver
2667,2695,9,551,376464,1,1,1,3,Platinum
2668,2696,55,35,51379,3,3,3,9,Silver
2669,2697,89,130,123687,3,1,2,6,Gold
2670,2698,37,506,414385,2,1,1,4,Platinum
2671,2700,30,103,328544,2,1,1,4,Platinum
2672,2701,13,218,75929,1,1,3,5,Platinum
2673,2702,212,8,16049,4,4,4,12,Bronze
2674,2703,48,385,234201,2,1,1,4,Platinum
2675,2704,24,33,62454,2,3,3,8,Gold
2676,2705,24,90,116827,2,2,2,6,Gold
2677,2706,246,86,50154,4,2,3,9,Silver
2678,2707,10,212,440700,1,1,1,3,Platinum
2679,2708,36,94,180078,2,2,2,6,Gold
2680,2709,5,129,3050434,1,1,1,3,Platinum
2681,2710,39,145,79207,2,1,3,6,Gold
2682,2711,4,181,115498,1,1,2,4,Platinum
2683,2712,4,235,182493,1,1,2,4,Platinum
2684,2713,48,32,26458,2,3,4,9,Silver
2685,2714,41,28,51509,2,3,3,8,Gold
2686,2715,47,160,465329,2,1,1,4,Platinum
2687,2716,17,46,111136,1,2,2,5,Platinum
2688,2717,261,76,75982,4,2,3,9,Silver
2689,2718,47,101,91172,2,1,2,5,Platinum
2690,2719,13,62,47878,1,2,3,6,Gold
2691,2720,30,28,61750,2,3,3,8,Gold
2692,2721,44,32,34846,2,3,4,9,Silver
2693,2722,96,16,147223,3,4,2,9,Silver
2694,2723,42,220,5775873,2,1,1,4,Platinum
2695,2724,310,29,44172,4,3,3,10,Silver
2696,2725,93,100,75550,3,2,3,8,Gold
2697,2726,6,1137,1054784,1,1,1,3,Platinum
2698,2727,198,22,57229,4,3,3,10,Silver
2699,2728,88,55,113622,3,2,2,7,Gold
2700,2729,270,39,109698,4,3,2,9,Silver
2701,2730,12,26,61066,1,3,3,7,Gold
2702,2731,66,65,164893,3,2,2,7,Gold
2703,2732,33,5,245476,2,4,1,7,Gold
2704,2733,23,71,157374,2,2,2,6,Gold
2705,2734,39,39,101691,2,3,2,7,Gold
2706,2735,122,83,180043,3,2,2,7,Gold
2707,2736,375,8,32676,4,4,4,12,Bronze
2708,2737,41,312,145860,2,1,2,5,Platinum
2709,2738,175,10,26358,4,4,4,12,Bronze
2710,2739,55,34,50292,3,3,3,9,Silver
2711,2740,33,84,230547,2,2,1,5,Platinum
2712,2741,146,70,95153,4,2,2,8,Gold
2713,2742,221,8,14489,4,4,4,12,Bronze
2714,2743,46,68,81782,2,2,3,7,Gold
2715,2744,17,121,272342,1,1,1,3,Platinum
2716,2745,68,180,176559,3,1,2,6,Gold
2717,2747,11,64,161666,1,2,2,5,Platinum
2718,2748,261,23,46572,4,3,3,10,Silver
2719,2749,366,74,47133,4,2,3,9,Silver
2720,2750,17,102,200773,1,1,2,4,Platinum
2721,2751,24,33,105656,2,3,2,7,Gold
2722,2752,46,21,43912,2,3,3,8,Gold
2723,2753,289,23,66708,4,3,3,10,Silver
2724,2754,305,1,15648,4,4,4,12,Bronze
2725,2755,4,129,299777,1,1,1,3,Platinum
2726,2756,289,1,9376,4,4,4,12,Bronze
2727,2757,17,21,169431,1,3,2,6,Gold
2728,2758,82,10,27904,3,4,4,11,Bronze
2729,2759,57,227,349151,3,1,1,5,Platinum
2730,2760,101,31,175602,3,3,2,8,Gold
2731,2761,300,38,54832,4,3,3,10,Silver
2732,2762,25,167,131409,2,1,2,5,Platinum
2733,2763,60,39,140341,3,3,2,8,Gold
2734,2764,157,18,39579,4,3,3,10,Silver
2735,2765,115,51,116194,3,2,2,7,Gold
2736,2766,116,1,2100,3,4,4,11,Bronze
2737,2767,12,63,143283,1,2,2,5,Platinum
2738,2768,265,12,38200,4,4,4,12,Bronze
2739,2769,241,10,23935,4,4,4,12,Bronze
2740,2770,88,67,223635,3,2,1,6,Gold
2741,2771,52,39,95948,2,3,2,7,Gold
2742,2772,71,76,169592,3,2,2,7,Gold
2743,2773,43,57,227112,2,2,1,5,Platinum
2744,2774,15,48,171170,1,2,2,5,Platinum
2745,2775,62,29,37344,3,3,4,10,Silver
2746,2776,249,13,54198,4,4,3,11,Bronze
2747,2777,67,6,14724,3,4,4,11,Bronze
2748,2778,21,31,371084,2,3,1,6,Gold
2749,2779,85,48,118362,3,2,2,7,Gold
2750,2780,219,18,98340,4,3,2,9,Silver
2751,2781,46,354,170786,2,1,2,5,Platinum
2752,2782,144,16,58218,4,4,3,11,Bronze
2753,2783,185,30,23673,4,3,4,11,Bronze
2754,2784,172,8,15784,4,4,4,12,Bronze
2755,2785,10,284,217121,1,1,1,3,Platinum
2756,2786,212,34,73643,4,3,3,10,Silver
2757,2787,190,30,30389,4,3,4,11,Bronze
2758,2788,10,16,55740,1,4,3,8,Gold
2759,2789,60,30,178981,3,3,2,8,Gold
2760,2790,58,212,114088,3,1,2,6,Gold
2761,2791,77,38,126900,3,3,2,8,Gold
2762,2792,53,16,41074,3,4,3,10,Silver
2763,2793,318,11,26876,4,4,4,12,Bronze
2764,2794,368,13,33888,4,4,4,12,Bronze
2765,2795,30,117,745905,2,1,1,4,Platinum
2766,2796,40,40,84640,2,3,3,8,Gold
2767,2797,18,89,234945,1,2,1,4,Platinum
2768,2798,52,78,431200,2,2,1,5,Platinum
2769,2799,4,338,1899538,1,1,1,3,Platinum
2770,2800,22,35,82425,2,3,3,8,Gold
2771,2801,263,21,61196,4,3,3,10,Silver
2772,2802,60,37,94538,3,3,2,8,Gold
2773,2804,19,31,78464,1,3,3,7,Gold
2774,2805,66,35,116800,3,3,2,8,Gold
2775,2806,89,30,75889,3,3,3,9,Silver
2776,2807,250,37,73369,4,3,3,10,Silver
2777,2808,4,117,291882,1,1,1,3,Platinum
2778,2809,251,1,18160,4,4,4,12,Bronze
2779,2810,9,224,529608,1,1,1,3,Platinum
2780,2811,166,29,93665,4,3,2,9,Silver
2781,2812,135,22,50301,3,3,3,9,Silver
2782,2813,306,1,14328,4,4,4,12,Bronze
2783,2814,6,18,48504,1,3,3,7,Gold
2784,2815,43,117,257434,2,1,1,4,Platinum
2785,2816,269,29,222850,4,3,1,8,Gold
2786,2817,50,89,235829,2,2,1,5,Platinum
2787,2818,9,130,380093,1,1,1,3,Platinum
2788,2819,16,18,92062,1,3,2,6,Gold
2789,2820,282,14,49072,4,4,3,11,Bronze
2790,2821,67,20,171500,3,3,2,8,Gold
2791,2822,2,474,684115,1,1,1,3,Platinum
2792,2823,257,2,4022,4,4,4,12,Bronze
2793,2824,236,6,97873,4,4,2,10,Silver
2794,2825,18,34,103454,1,3,2,6,Gold
2795,2826,15,98,468900,1,2,1,4,Platinum
2796,2827,9,85,257999,1,2,1,4,Platinum
2797,2828,52,125,264445,2,1,1,4,Platinum
2798,2829,61,3,8070,3,4,4,11,Bronze
2799,2830,96,69,157257,3,2,2,7,Gold
2800,2831,16,84,171583,1,2,2,5,Platinum
2801,2832,128,23,131800,3,3,2,8,Gold
2802,2833,95,58,127367,3,2,2,7,Gold
2803,2834,52,15,38536,2,4,4,10,Silver
2804,2835,139,8,24684,3,4,4,11,Bronze
2805,2836,61,11,27602,3,4,4,11,Bronze
2806,2837,101,162,1344062,3,1,1,5,Platinum
2807,2838,74,11,39478,3,4,3,10,Silver
2808,2839,75,28,855461,3,3,1,7,Gold
2809,2840,68,15,40174,3,4,3,10,Silver
2810,2841,65,45,147151,3,2,2,7,Gold
2811,2842,17,31,65303,1,3,3,7,Gold
2812,2843,23,218,553224,2,1,1,4,Platinum
2813,2844,32,295,950577,2,1,1,4,Platinum
2814,2845,45,67,140508,2,2,2,6,Gold
2815,2846,16,11,27300,1,4,4,9,Silver
2816,2847,43,6,26436,2,4,4,10,Silver
2817,2848,3,134,662754,1,1,1,3,Platinum
2818,2849,237,19,44311,4,3,3,10,Silver
2819,2850,78,14,48552,3,4,3,10,Silver
2820,2851,5,179,135244,1,1,2,4,Platinum
2821,2852,4,111,250576,1,1,1,3,Platinum
2822,2853,361,18,49208,4,3,3,10,Silver
2823,2854,59,35,70708,3,3,3,9,Silver
2824,2855,24,57,53737,2,2,3,7,Gold
2825,2856,34,97,100801,2,2,2,6,Gold
2826,2857,55,63,69915,3,2,3,8,Gold
2827,2858,26,19,45412,2,3,3,8,Gold
2828,2859,45,66,86813,2,2,2,6,Gold
2829,2860,89,45,147561,3,2,2,7,Gold
2830,2861,3,115,952138,1,1,1,3,Platinum
2831,2862,89,23,60724,3,3,3,9,Silver
2832,2863,20,41,78752,2,3,3,8,Gold
2833,2864,83,6,17310,3,4,4,11,Bronze
2834,2865,172,44,128257,4,2,2,8,Gold
2835,2866,81,14,29233,3,4,4,11,Bronze
2836,2867,268,37,105563,4,3,2,9,Silver
2837,2868,236,15,34611,4,4,4,12,Bronze
2838,2869,30,84,405046,2,2,1,5,Platinum
2839,2870,37,97,118323,2,2,2,6,Gold
2840,2871,319,137,103734,4,1,2,7,Gold
2841,2872,58,96,192044,3,2,2,7,Gold
2842,2873,45,134,133144,2,1,2,5,Platinum
2843,2874,211,8,36966,4,4,4,12,Bronze
2844,2875,227,6,33702,4,4,4,12,Bronze
2845,2876,88,47,119004,3,2,2,7,Gold
2846,2877,190,35,72124,4,3,3,10,Silver
2847,2878,44,37,125491,2,3,2,7,Gold
2848,2879,72,22,62066,3,3,3,9,Silver
2849,2880,41,45,102061,2,2,2,6,Gold
2850,2881,79,20,52358,3,3,3,9,Silver
2851,2882,57,19,52468,3,3,3,9,Silver
2852,2883,25,135,458293,2,1,1,4,Platinum
2853,2884,10,662,335176,1,1,1,3,Platinum
2854,2885,9,294,457816,1,1,1,3,Platinum
2855,2886,34,51,46405,2,2,3,7,Gold
2856,2887,212,91,195538,4,2,2,8,Gold
2857,2888,24,90,182497,2,2,2,6,Gold
2858,2889,171,16,21387,4,4,4,12,Bronze
2859,2890,64,7,19650,3,4,4,11,Bronze
2860,2891,53,69,221259,3,2,1,6,Gold
2861,2892,262,24,50692,4,3,3,10,Silver
2862,2894,67,123,529764,3,1,1,5,Platinum
2863,2895,17,270,333263,1,1,1,3,Platinum
2864,2896,267,13,106390,4,4,2,10,Silver
2865,2897,177,2,4859,4,4,4,12,Bronze
2866,2898,46,135,670301,2,1,1,4,Platinum
2867,2899,51,18,116825,2,3,2,7,Gold
2868,2900,18,124,91129,1,1,2,4,Platinum
2869,2902,10,258,663696,1,1,1,3,Platinum
2870,2903,75,61,106260,3,2,2,7,Gold
2871,2904,72,45,93077,3,2,2,7,Gold
2872,2905,354,54,146451,4,2,2,8,Gold
2873,2906,8,133,192433,1,1,2,4,Platinum
2874,2907,117,25,56421,3,3,3,9,Silver
2875,2908,374,65,41179,4,2,3,9,Silver
2876,2909,197,33,77529,4,3,3,10,Silver
2877,2910,177,6,110868,4,4,2,10,Silver
2878,2911,101,23,62785,3,3,3,9,Silver
2879,2912,22,107,205402,2,1,2,5,Platinum
2880,2913,73,17,257648,3,4,1,8,Gold
2881,2914,340,11,22909,4,4,4,12,Bronze
2882,2915,7,165,218956,1,1,1,3,Platinum
2883,2916,32,109,103808,2,1,2,5,Platinum
2884,2917,170,8,18412,4,4,4,12,Bronze
2885,2918,122,17,39900,3,4,3,10,Silver
2886,2919,22,118,274070,2,1,1,4,Platinum
2887,2920,10,79,182104,1,2,2,5,Platinum
2888,2921,269,20,41449,4,3,3,10,Silver
2889,2922,23,27,69082,2,3,3,8,Gold
2890,2923,127,11,31426,3,4,4,11,Bronze
2891,2924,26,162,661576,2,1,1,4,Platinum
2892,2925,139,22,49172,3,3,3,9,Silver
2893,2926,217,41,88527,4,3,2,9,Silver
2894,2927,264,1,37000,4,4,4,12,Bronze
2895,2928,107,42,91710,3,2,2,7,Gold
2896,2929,18,37,80726,1,3,3,7,Gold
2897,2930,5,16,39061,1,4,4,9,Silver
2898,2931,331,14,26600,4,4,4,12,Bronze
2899,2932,65,151,368334,3,1,1,5,Platinum
2900,2933,120,69,179956,3,2,2,7,Gold
2901,2934,36,19,43982,2,3,3,8,Gold
2902,2935,220,3,43056,4,4,3,11,Bronze
2903,2936,173,56,136474,4,2,2,8,Gold
2904,2937,76,12,45717,3,4,3,10,Silver
2905,2938,2,37,45861,1,3,3,7,Gold
2906,2939,198,1,23750,4,4,4,12,Bronze
2907,2940,129,118,55678,3,1,3,7,Gold
2908,2941,49,18,71674,2,3,3,8,Gold
2909,2942,6,319,346057,1,1,1,3,Platinum
2910,2943,15,318,525295,1,1,1,3,Platinum
2911,2944,18,39,28668,1,3,4,8,Gold
2912,2945,30,153,200991,2,1,2,5,Platinum
2913,2946,12,30,1448208,1,3,1,5,Platinum
2914,2947,37,10,20362,2,4,4,10,Silver
2915,2948,158,11,27120,4,4,4,12,Bronze
2916,2949,285,20,11915,4,3,4,11,Bronze
2917,2950,108,153,81573,3,1,3,7,Gold
2918,2951,25,77,256785,2,2,1,5,Platinum
2919,2952,77,15,40997,3,4,3,10,Silver
2920,2953,17,47,47644,1,2,3,6,Gold
2921,2954,161,2,10674,4,4,4,12,Bronze
2922,2955,45,38,72533,2,3,3,8,Gold
2923,2956,12,92,106483,1,2,2,5,Platinum
2924,2957,35,234,195058,2,1,2,5,Platinum
2925,2958,292,9,5798,4,4,4,12,Bronze
2926,2959,22,57,136603,2,2,2,6,Gold
2927,2960,335,8,20380,4,4,4,12,Bronze
2928,2961,18,28,64118,1,3,3,7,Gold
2929,2962,10,94,769126,1,2,1,4,Platinum
2930,2963,65,39,46831,3,3,3,9,Silver
2931,2964,198,31,25745,4,3,4,11,Bronze
2932,2965,34,34,78984,2,3,3,8,Gold
2933,2966,2,109,265122,1,1,1,3,Platinum
2934,2967,8,66,233661,1,2,1,4,Platinum
2935,2968,5,662,454411,1,1,1,3,Platinum
2936,2969,11,106,111914,1,1,2,4,Platinum
2937,2970,33,81,89813,2,2,2,6,Gold
2938,2971,55,5,14180,3,4,4,11,Bronze
2939,2972,12,53,83408,1,2,3,6,Gold
2940,2973,22,51,179530,2,2,2,6,Gold
2941,2974,21,18,48036,2,3,3,8,Gold
2942,2975,38,130,110631,2,1,2,5,Platinum
2943,2976,3,76,62530,1,2,3,6,Gold
2944,2977,19,116,204424,1,1,2,4,Platinum
2945,2978,83,228,163300,3,1,2,6,Gold
2946,2979,34,97,45106,2,2,3,7,Gold
2947,2980,67,110,57238,3,1,3,7,Gold
2948,2981,9,125,137986,1,1,2,4,Platinum
2949,2982,268,4,88140,4,4,2,10,Silver
2950,2983,251,23,51182,4,3,3,10,Silver
2951,2984,5,108,290240,1,1,1,3,Platinum
2952,2985,62,31,163178,3,3,2,8,Gold
2953,2986,75,102,86584,3,1,2,6,Gold
2954,2987,91,33,72480,3,3,3,9,Silver
2955,2988,61,59,69213,3,2,3,8,Gold
2956,2989,29,88,42015,2,2,3,7,Gold
2957,2990,329,4,13168,4,4,4,12,Bronze
2958,2991,54,34,221279,3,3,1,7,Gold
2959,2992,270,45,32780,4,2,4,10,Silver
2960,2993,3,330,385006,1,1,1,3,Platinum
2961,2994,59,83,303664,3,2,1,6,Gold
2962,2995,61,210,225109,3,1,1,5,Platinum
2963,2996,155,82,213780,4,2,1,7,Gold
2964,2997,20,72,54448,2,2,3,7,Gold
2965,2998,95,29,41275,3,3,3,9,Silver
2966,2999,2,186,606557,1,1,1,3,Platinum
2967,3000,268,60,39584,4,2,3,9,Silver
2968,3001,313,10,22112,4,4,4,12,Bronze
2969,3002,72,23,54904,3,3,3,9,Silver
2970,3003,305,5,33756,4,4,4,12,Bronze
2971,3004,19,62,23362,1,2,4,7,Gold
2972,3005,13,172,273686,1,1,1,3,Platinum
2973,3006,37,232,273260,2,1,1,4,Platinum
2974,3007,20,45,27448,2,2,4,8,Gold
2975,3008,54,35,18987,3,3,4,10,Silver
2976,3009,57,31,34447,3,3,4,10,Silver
2977,3010,23,7,14333,2,4,4,10,Silver
2978,3011,45,54,29210,2,2,4,8,Gold
2979,3012,27,71,140047,2,2,2,6,Gold
2980,3013,45,102,80862,2,1,3,6,Gold
2981,3014,113,51,123113,3,2,2,7,Gold
2982,3015,18,369,5138859,1,1,1,3,Platinum
2983,3016,25,18,44294,2,3,3,8,Gold
2984,3017,195,5,17636,4,4,4,12,Bronze
2985,3018,303,21,43146,4,3,3,10,Silver
2986,3019,3,372,256284,1,1,1,3,Platinum
2987,3020,264,9,30820,4,4,4,12,Bronze
2988,3022,111,2,28507,3,4,4,11,Bronze
2989,3023,59,6,34727,3,4,4,11,Bronze
2990,3024,214,83,85782,4,2,3,9,Silver
2991,3025,65,8,45888,3,4,3,10,Silver
2992,3026,29,17,25517,2,4,4,10,Silver
2993,3027,31,109,193443,2,1,2,5,Platinum
2994,3028,6,132,104993,1,1,2,4,Platinum
2995,3029,8,282,465064,1,1,1,3,Platinum
2996,3030,71,24,46056,3,3,3,9,Silver
2997,3031,2,174,83447,1,1,3,5,Platinum
2998,3032,47,84,91709,2,2,2,6,Gold
2999,3033,34,63,29355,2,2,4,8,Gold
3000,3034,212,2,388,4,4,4,12,Bronze
3001,3035,136,36,38148,3,3,4,10,Silver
3002,3036,199,20,22390,4,3,4,11,Bronze
3003,3037,198,40,88620,4,3,2,9,Silver
3004,3038,151,11,40792,4,4,3,11,Bronze
3005,3039,88,14,32861,3,4,4,11,Bronze
3006,3040,73,1,734,3,4,4,11,Bronze
3007,3041,64,99,229732,3,2,1,6,Gold
3008,3042,100,111,280874,3,1,1,5,Platinum
3009,3043,220,9,26288,4,4,4,12,Bronze
3010,3044,7,202,458410,1,1,1,3,Platinum
3011,3045,30,135,120173,2,1,2,5,Platinum
3012,3046,179,33,17486,4,3,4,11,Bronze
3013,3047,83,3,13908,3,4,4,11,Bronze
3014,3048,22,82,202111,2,2,2,6,Gold
3015,3049,20,236,185437,2,1,2,5,Platinum
3016,3050,34,148,199772,2,1,2,5,Platinum
3017,3051,83,2,10559,3,4,4,11,Bronze
3018,3052,24,182,78220,2,1,3,6,Gold
3019,3053,52,170,99767,2,1,2,5,Platinum
3020,3054,275,13,29306,4,4,4,12,Bronze
3021,3055,165,18,41940,4,3,3,10,Silver
3022,3056,8,359,232830,1,1,1,3,Platinum
3023,3057,90,28,69768,3,3,3,9,Silver
3024,3058,64,146,320997,3,1,1,5,Platinum
3025,3059,26,17,43804,2,4,3,9,Silver
3026,3060,11,35,35167,1,3,4,8,Gold
3027,3061,76,53,100727,3,2,2,7,Gold
3028,3062,16,18,39044,1,3,4,8,Gold
3029,3063,193,19,15618,4,3,4,11,Bronze
3030,3064,177,25,51283,4,3,3,10,Silver
3031,3065,78,42,46786,3,2,3,8,Gold
3032,3066,36,29,78688,2,3,3,8,Gold
3033,3067,47,39,93821,2,3,2,7,Gold
3034,3068,80,56,189937,3,2,2,7,Gold
3035,3069,297,50,123730,4,2,2,8,Gold
3036,3070,4,97,85755,1,2,3,6,Gold
3037,3071,9,95,211349,1,2,1,4,Platinum
3038,3072,50,136,372281,2,1,1,4,Platinum
3039,3073,163,15,12434,4,4,4,12,Bronze
3040,3074,361,19,42615,4,3,3,10,Silver
3041,3075,8,11,46376,1,4,3,8,Gold
3042,3076,109,84,173413,3,2,2,7,Gold
3043,3077,26,86,75908,2,2,3,7,Gold
3044,3078,36,4,115056,2,4,2,8,Gold
3045,3079,21,3,11112,2,4,4,10,Silver
3046,3080,298,13,39173,4,4,4,12,Bronze
3047,3081,373,13,31095,4,4,4,12,Bronze
3048,3082,22,168,119251,2,1,2,5,Platinum
3049,3083,12,35,109779,1,3,2,6,Gold
3050,3084,53,113,196078,3,1,2,6,Gold
3051,3085,31,6,12046,2,4,4,10,Silver
3052,3086,279,17,20097,4,4,4,12,Bronze
3053,3087,62,40,62359,3,3,3,9,Silver
3054,3088,28,12,23637,2,4,4,10,Silver
3055,3089,187,156,134444,4,1,2,7,Gold
3056,3090,2,290,1151990,1,1,1,3,Platinum
3057,3091,5,183,1670556,1,1,1,3,Platinum
3058,3092,173,15,34920,4,4,4,12,Bronze
3059,3093,82,14,27954,3,4,4,11,Bronze
3060,3094,4,17,35499,1,4,4,9,Silver
3061,3095,191,30,55492,4,3,3,10,Silver
3062,3096,24,77,168003,2,2,2,6,Gold
3063,3097,145,1,54144,4,4,3,11,Bronze
3064,3098,20,177,140940,2,1,2,5,Platinum
3065,3099,6,31,81238,1,3,3,7,Gold
3066,3100,111,55,68181,3,2,3,8,Gold
3067,3101,4,45,166627,1,2,2,5,Platinum
3068,3102,54,5,13588,3,4,4,11,Bronze
3069,3103,173,3,36648,4,4,4,12,Bronze
3070,3104,291,25,103575,4,3,2,9,Silver
3071,3105,11,981,531891,1,1,1,3,Platinum
3072,3106,109,251,310288,3,1,1,5,Platinum
3073,3107,96,32,133577,3,3,2,8,Gold
3074,3108,243,17,47281,4,4,3,11,Bronze
3075,3109,164,84,795318,4,2,1,7,Gold
3076,3110,43,52,105404,2,2,2,6,Gold
3077,3111,37,17,36701,2,4,4,10,Silver
3078,3112,67,207,422307,3,1,1,5,Platinum
3079,3113,26,11,34969,2,4,4,10,Silver
3080,3114,1,460,1107757,1,1,1,3,Platinum
3081,3115,27,57,108340,2,2,2,6,Gold
3082,3116,7,31,65615,1,3,3,7,Gold
3083,3117,54,19,134462,3,3,2,8,Gold
3084,3118,365,3,18035,4,4,4,12,Bronze
3085,3119,20,18,77568,2,3,3,8,Gold
3086,3120,195,35,116957,4,3,2,9,Silver
3087,3121,4,5,17489,1,4,4,9,Silver
3088,3122,16,126,475745,1,1,1,3,Platinum
3089,3123,27,87,197170,2,2,2,6,Gold
3090,3124,128,57,125377,3,2,2,7,Gold
3091,3125,85,42,86478,3,2,2,7,Gold
3092,3126,72,28,61960,3,3,3,9,Silver
3093,3128,183,9,17036,4,4,4,12,Bronze
3094,3129,115,6,42924,3,4,3,10,Silver
3095,3130,374,14,28602,4,4,4,12,Bronze
3096,3131,82,28,108606,3,3,2,8,Gold
3097,3132,250,8,51949,4,4,3,11,Bronze
3098,3133,233,13,27140,4,4,4,12,Bronze
3099,3134,72,33,60393,3,3,3,9,Silver
3100,3135,69,10,23100,3,4,4,11,Bronze
3101,3136,5,216,555469,1,1,1,3,Platinum
3102,3137,52,27,38760,2,3,4,9,Silver
3103,3138,76,53,21308,3,2,4,9,Silver
3104,3139,62,85,54245,3,2,3,8,Gold
3105,3140,21,12,30020,2,4,4,10,Silver
3106,3141,5,7,19356,1,4,4,9,Silver
3107,3142,286,10,18663,4,4,4,12,Bronze
3108,3143,5,62,136385,1,2,2,5,Platinum
3109,3144,41,30,32543,2,3,4,9,Silver
3110,3145,37,29,70380,2,3,3,8,Gold
3111,3146,76,34,71675,3,3,3,9,Silver
3112,3147,18,172,464847,1,1,1,3,Platinum
3113,3148,16,276,672326,1,1,1,3,Platinum
3114,3149,220,6,10530,4,4,4,12,Bronze
3115,3150,187,10,15319,4,4,4,12,Bronze
3116,3151,33,66,146993,2,2,2,6,Gold
3117,3152,71,30,77773,3,3,3,9,Silver
3118,3153,183,26,63119,4,3,3,10,Silver
3119,3154,16,33,69203,1,3,3,7,Gold
3120,3155,236,5,21501,4,4,4,12,Bronze
3121,3156,32,96,323107,2,2,1,5,Platinum
3122,3157,264,14,27916,4,4,4,12,Bronze
3123,3158,6,9,23410,1,4,4,9,Silver
3124,3159,54,29,97077,3,3,2,8,Gold
3125,3160,248,5,15204,4,4,4,12,Bronze
3126,3161,81,48,109831,3,2,2,7,Gold
3127,3162,275,23,41551,4,3,3,10,Silver
3128,3163,1,179,572022,1,1,1,3,Platinum
3129,3164,80,20,39419,3,3,3,9,Silver
3130,3165,30,117,283322,2,1,1,4,Platinum
3131,3166,74,64,70407,3,2,3,8,Gold
3132,3167,18,152,342281,1,1,1,3,Platinum
3133,3168,223,9,25108,4,4,4,12,Bronze
3134,3169,33,69,159720,2,2,2,6,Gold
3135,3170,24,94,228655,2,2,1,5,Platinum
3136,3171,32,50,150055,2,2,2,6,Gold
3137,3172,106,12,33334,3,4,4,11,Bronze
3138,3173,5,34,94075,1,3,2,6,Gold
3139,3174,246,27,64363,4,3,3,10,Silver
3140,3175,179,62,124130,4,2,2,8,Gold
3141,3176,173,14,29753,4,4,4,12,Bronze
3142,3177,44,19,41370,2,3,3,8,Gold
3143,3178,72,24,70388,3,3,3,9,Silver
3144,3179,59,118,851875,3,1,1,5,Platinum
3145,3180,18,69,156867,1,2,2,5,Platinum
3146,3181,142,29,74481,3,3,3,9,Silver
3147,3182,18,261,507784,1,1,1,3,Platinum
3148,3183,27,73,1351856,2,2,1,5,Platinum
3149,3184,10,208,159914,1,1,2,4,Platinum
3150,3185,373,8,13708,4,4,4,12,Bronze
3151,3186,198,2,8688,4,4,4,12,Bronze
3152,3187,17,16,157439,1,4,2,7,Gold
3153,3188,363,9,17591,4,4,4,12,Bronze
3154,3189,20,32,23720,2,3,4,9,Silver
3155,3190,69,53,71747,3,2,3,8,Gold
3156,3191,17,20,49638,1,3,3,7,Gold
3157,3192,24,158,185962,2,1,2,5,Platinum
3158,3193,24,252,541048,2,1,1,4,Platinum
3159,3194,32,6,195229,2,4,2,8,Gold
3160,3195,3,114,960540,1,1,1,3,Platinum
3161,3196,55,98,41568,3,2,3,8,Gold
3162,3197,34,89,188071,2,2,2,6,Gold
3163,3198,3,163,434275,1,1,1,3,Platinum
3164,3199,374,3,14783,4,4,4,12,Bronze
3165,3200,48,10,23316,2,4,4,10,Silver
3166,3201,74,44,246345,3,2,1,6,Gold
3167,3202,5,30,154140,1,3,2,6,Gold
3168,3203,5,268,8105059,1,1,1,3,Platinum
3169,3204,62,62,49312,3,2,3,8,Gold
3170,3205,48,585,412943,2,1,1,4,Platinum
3171,3206,2,62,165181,1,2,2,5,Platinum
3172,3207,77,13,61904,3,4,3,10,Silver
3173,3208,73,12,29085,3,4,4,11,Bronze
3174,3209,294,1,875,4,4,4,12,Bronze
3175,3210,69,60,60477,3,2,3,8,Gold
3176,3211,139,10,73116,3,4,3,10,Silver
3177,3212,242,21,12778,4,3,4,11,Bronze
3178,3213,256,4,143160,4,4,2,10,Silver
3179,3214,9,308,704483,1,1,1,3,Platinum
3180,3215,9,144,903553,1,1,1,3,Platinum
3181,3216,2,270,1689593,1,1,1,3,Platinum
3182,3217,38,123,65414,2,1,3,6,Gold
3183,3218,46,27,80616,2,3,3,8,Gold
3184,3219,85,79,341161,3,2,1,6,Gold
3185,3220,20,402,344984,2,1,1,4,Platinum
3186,3221,4,22,209357,1,3,2,6,Gold
3187,3222,17,446,449622,1,1,1,3,Platinum
3188,3223,19,624,904773,1,1,1,3,Platinum
3189,3224,224,93,148807,4,2,2,8,Gold
3190,3225,79,19,63310,3,3,3,9,Silver
3191,3226,275,2,93600,4,4,2,10,Silver
3192,3227,24,199,472856,2,1,1,4,Platinum
3193,3228,370,45,87845,4,2,2,8,Gold
3194,3229,15,201,242190,1,1,1,3,Platinum
3195,3230,27,27,24018,2,3,4,9,Silver
3196,3231,263,37,36747,4,3,4,11,Bronze
3197,3232,18,225,705704,1,1,1,3,Platinum
3198,3233,92,43,72472,3,2,3,8,Gold
3199,3234,304,150,90437,4,1,2,7,Gold
3200,3235,27,185,191539,2,1,2,5,Platinum
3201,3236,365,46,35727,4,2,4,10,Silver
3202,3237,47,269,140091,2,1,2,5,Platinum
3203,3238,39,659,1020155,2,1,1,4,Platinum
3204,3239,53,82,130496,3,2,2,7,Gold
3205,3240,32,28,79455,2,3,3,8,Gold
3206,3241,53,53,86255,3,2,2,7,Gold
3207,3242,79,125,307505,3,1,1,5,Platinum
3208,3243,58,1,51552,3,4,3,10,Silver
3209,3244,307,1,501,4,4,4,12,Bronze
3210,3245,177,13,38626,4,4,4,12,Bronze
3211,3247,30,191,330142,2,1,1,4,Platinum
3212,3248,12,242,170453,1,1,2,4,Platinum
3213,3249,87,357,1037376,3,1,1,5,Platinum
3214,3250,5,449,896109,1,1,1,3,Platinum
3215,3251,38,42,112005,2,2,2,6,Gold
3216,3252,18,69,201032,1,2,2,5,Platinum
3217,3253,45,95,73890,2,2,3,7,Gold
3218,3254,31,24,142053,2,3,2,7,Gold
3219,3255,375,9,23431,4,4,4,12,Bronze
3220,3256,59,34,33918,3,3,4,10,Silver
3221,3258,115,170,210959,3,1,1,5,Platinum
3222,3259,215,13,30532,4,4,4,12,Bronze
3223,3260,319,7,16365,4,4,4,12,Bronze
3224,3261,66,22,48816,3,3,3,9,Silver
3225,3262,8,42,107474,1,2,2,5,Platinum
3226,3263,97,13,48581,3,4,3,10,Silver
3227,3264,20,89,177858,2,2,2,6,Gold
3228,3265,199,23,81941,4,3,3,10,Silver
3229,3266,4,706,343348,1,1,1,3,Platinum
3230,3267,299,1,3552,4,4,4,12,Bronze
3231,3268,274,34,145894,4,3,2,9,Silver
3232,3269,31,222,777635,2,1,1,4,Platinum
3233,3270,49,54,57182,2,2,3,7,Gold
3234,3271,261,40,41932,4,3,3,10,Silver
3235,3272,58,145,100142,3,1,2,6,Gold
3236,3273,35,254,296617,2,1,1,4,Platinum
3237,3274,58,26,26400,3,3,4,10,Silver
3238,3275,68,48,82704,3,2,3,8,Gold
3239,3276,12,158,190347,1,1,2,4,Platinum
3240,3277,61,76,50889,3,2,3,8,Gold
3241,3278,81,50,25911,3,2,4,9,Silver
3242,3279,76,16,34442,3,4,4,11,Bronze
3243,3280,3,333,1339828,1,1,1,3,Platinum
3244,3281,101,60,56899,3,2,3,8,Gold
3245,3282,374,17,36396,4,4,4,12,Bronze
3246,3283,18,190,262786,1,1,1,3,Platinum
3247,3284,22,3,12000,2,4,4,10,Silver
3248,3285,124,154,75000,3,1,3,7,Gold
3249,3286,12,5,9998,1,4,4,9,Silver
3250,3287,4,93,205287,1,2,2,5,Platinum
3251,3288,30,319,210168,2,1,2,5,Platinum
3252,3289,283,12,13624,4,4,4,12,Bronze
3253,3290,58,16,29688,3,4,4,11,Bronze
3254,3291,2,284,170524,1,1,2,4,Platinum
3255,3292,366,66,54287,4,2,3,9,Silver
3256,3293,90,18,39270,3,3,4,10,Silver
3257,3294,12,164,146478,1,1,2,4,Platinum
3258,3295,167,76,188901,4,2,2,8,Gold
3259,3296,66,24,48005,3,3,3,9,Silver
3260,3297,24,60,66257,2,2,3,7,Gold
3261,3298,174,98,69302,4,2,3,9,Silver
3262,3299,104,102,95733,3,1,2,6,Gold
3263,3300,144,67,150294,4,2,2,8,Gold
3264,3301,100,23,40258,3,3,3,9,Silver
3265,3302,24,149,124231,2,1,2,5,Platinum
3266,3303,193,15,38216,4,4,4,12,Bronze
3267,3304,5,28,79425,1,3,3,7,Gold
3268,3305,361,15,52538,4,4,3,11,Bronze
3269,3306,9,449,256988,1,1,1,3,Platinum
3270,3307,15,323,786658,1,1,1,3,Platinum
3271,3308,104,28,56544,3,3,3,9,Silver
3272,3309,4,86,203163,1,2,2,5,Platinum
3273,3310,11,189,438436,1,1,1,3,Platinum
3274,3311,96,26,59751,3,3,3,9,Silver
3275,3312,228,38,42323,4,3,3,10,Silver
3276,3313,16,26,60878,1,3,3,7,Gold
3277,3314,39,28,111816,2,3,2,7,Gold
3278,3315,52,22,40409,2,3,3,8,Gold
3279,3316,113,7,15182,3,4,4,11,Bronze
3280,3317,157,11,23474,4,4,4,12,Bronze
3281,3318,39,23,45546,2,3,3,8,Gold
3282,3319,191,12,21842,4,4,4,12,Bronze
3283,3320,2,47,134791,1,2,2,5,Platinum
3284,3321,228,24,60636,4,3,3,10,Silver
3285,3322,134,10,21583,3,4,4,11,Bronze
3286,3323,40,11,33315,2,4,4,10,Silver
3287,3324,32,165,396865,2,1,1,4,Platinum
3288,3325,199,25,69598,4,3,3,10,Silver
3289,3326,9,266,2107553,1,1,1,3,Platinum
3290,3327,37,116,282177,2,1,1,4,Platinum
3291,3328,101,63,156789,3,2,2,7,Gold
3292,3329,43,378,1528947,2,1,1,4,Platinum
3293,3330,53,11,25652,3,4,4,11,Bronze
3294,3331,44,12,23600,2,4,4,10,Silver
3295,3332,53,14,39716,3,4,3,10,Silver
3296,3333,187,8,13967,4,4,4,12,Bronze
3297,3334,334,19,42776,4,3,3,10,Silver
3298,3335,8,20,46294,1,3,3,7,Gold
3299,3336,12,9,17285,1,4,4,9,Silver
3300,3337,25,19,39303,2,3,3,8,Gold
3301,3338,16,2,4170,1,4,4,9,Silver
3302,3339,369,10,41437,4,4,3,11,Bronze
3303,3340,145,52,120249,4,2,2,8,Gold
3304,3341,60,6,25424,3,4,4,11,Bronze
3305,3342,32,26,72808,2,3,3,8,Gold
3306,3343,142,11,24230,3,4,4,11,Bronze
3307,3344,23,128,108004,2,1,2,5,Platinum
3308,3345,23,137,345101,2,1,1,4,Platinum
3309,3346,78,7,93775,3,4,2,9,Silver
3310,3347,5,279,913994,1,1,1,3,Platinum
3311,3348,68,112,261051,3,1,1,5,Platinum
3312,3349,13,159,108853,1,1,2,4,Platinum
3313,3350,86,3,1763,3,4,4,11,Bronze
3314,3351,31,178,190440,2,1,2,5,Platinum
3315,3352,71,1,46200,3,4,3,10,Silver
3316,3353,67,39,96178,3,3,2,8,Gold
3317,3354,188,38,32996,4,3,4,11,Bronze
3318,3355,38,26,58859,2,3,3,8,Gold
3319,3356,16,101,56705,1,1,3,5,Platinum
3320,3357,36,37,26010,2,3,4,9,Silver
3321,3358,195,135,204321,4,1,2,7,Gold
3322,3359,2,203,95517,1,1,2,4,Platinum
3323,3360,2,99,64113,1,2,3,6,Gold
3324,3361,367,45,17894,4,2,4,10,Silver
3325,3362,65,69,27245,3,2,4,9,Silver
3326,3363,300,37,32917,4,3,4,11,Bronze
3327,3364,27,162,67990,2,1,3,6,Gold
3328,3365,8,125,155659,1,1,2,4,Platinum
3329,3366,21,78,129287,2,2,2,6,Gold
3330,3367,117,44,203120,3,2,2,7,Gold
3331,3368,30,60,48181,2,2,3,7,Gold
3332,3369,5,709,486006,1,1,1,3,Platinum
3333,3370,6,208,383372,1,1,1,3,Platinum
3334,3371,82,93,72422,3,2,3,8,Gold
3335,3372,31,151,111196,2,1,2,5,Platinum
3336,3373,73,18,49884,3,3,3,9,Silver
3337,3374,5,547,196963,1,1,2,4,Platinum
3338,3375,30,101,309345,2,1,1,4,Platinum
3339,3376,291,8,14310,4,4,4,12,Bronze
3340,3377,37,38,29666,2,3,4,9,Silver
3341,3378,10,57,69155,1,2,3,6,Gold
3342,3379,24,143,81403,2,1,3,6,Gold
3343,3380,277,9,50104,4,4,3,11,Bronze
3344,3381,54,128,139704,3,1,2,6,Gold
3345,3382,157,327,330978,4,1,1,6,Gold
3346,3383,62,60,24330,3,2,4,9,Silver
3347,3384,13,671,898625,1,1,1,3,Platinum
3348,3385,22,83,109708,2,2,2,6,Gold
3349,3386,373,14,24747,4,4,4,12,Bronze
3350,3387,118,6,67238,3,4,3,10,Silver
3351,3388,81,208,389144,3,1,1,5,Platinum
3352,3389,4,77,177644,1,2,2,5,Platinum
3353,3390,27,54,54681,2,2,3,7,Gold
3354,3391,6,898,623311,1,1,1,3,Platinum
3355,3392,54,53,20798,3,2,4,9,Silver
3356,3393,2,44,68836,1,2,3,6,Gold
3357,3394,55,62,115947,3,2,2,7,Gold
3358,3395,26,57,36216,2,2,4,8,Gold
3359,3396,10,240,241304,1,1,1,3,Platinum
3360,3397,53,305,420668,3,1,1,5,Platinum
3361,3398,13,281,234198,1,1,1,3,Platinum
3362,3399,212,33,89272,4,3,2,9,Silver
3363,3400,24,249,579088,2,1,1,4,Platinum
3364,3401,236,21,52890,4,3,3,10,Silver
3365,3402,139,19,155020,3,3,2,8,Gold
3366,3403,4,60,168952,1,2,2,5,Platinum
3367,3404,57,42,148561,3,2,2,7,Gold
3368,3405,137,86,190603,3,2,2,7,Gold
3369,3406,110,16,21431,3,4,4,11,Bronze
3370,3407,32,1,2650,2,4,4,10,Silver
3371,3408,3,54,267687,1,2,1,4,Platinum
3372,3409,186,25,63930,4,3,3,10,Silver
3373,3410,18,16,37058,1,4,4,9,Silver
3374,3411,240,16,52214,4,4,3,11,Bronze
3375,3412,88,7,14875,3,4,4,11,Bronze
3376,3413,39,100,64915,2,2,3,7,Gold
3377,3414,117,14,27795,3,4,4,11,Bronze
3378,3415,188,7,12983,4,4,4,12,Bronze
3379,3416,227,25,29149,4,3,4,11,Bronze
3380,3417,9,28,306599,1,3,1,5,Platinum
3381,3418,190,21,48144,4,3,3,10,Silver
3382,3419,6,31,59862,1,3,3,7,Gold
3383,3420,40,42,103922,2,2,2,6,Gold
3384,3421,39,41,39507,2,3,3,8,Gold
3385,3422,270,2,30496,4,4,4,12,Bronze
3386,3423,78,39,42687,3,3,3,9,Silver
3387,3424,5,89,225955,1,2,1,4,Platinum
3388,3425,256,87,150642,4,2,2,8,Gold
3389,3426,62,22,46490,3,3,3,9,Silver
3390,3427,13,148,258866,1,1,1,3,Platinum
3391,3428,89,407,576426,3,1,1,5,Platinum
3392,3429,18,120,647148,1,1,1,3,Platinum
3393,3430,31,2,9570,2,4,4,10,Silver
3394,3431,4,129,184826,1,1,2,4,Platinum
3395,3432,6,7,15299,1,4,4,9,Silver
3396,3433,16,12,186771,1,4,2,7,Gold
3397,3434,223,1,22500,4,4,4,12,Bronze
3398,3435,12,93,201007,1,2,2,5,Platinum
3399,3437,31,37,177131,2,3,2,7,Gold
3400,3438,290,12,89960,4,4,2,10,Silver
3401,3439,152,4,31426,4,4,4,12,Bronze
3402,3440,26,23,67781,2,3,3,8,Gold
3403,3441,1,169,497679,1,1,1,3,Platinum
3404,3442,86,49,185111,3,2,2,7,Gold
3405,3443,47,44,189031,2,2,2,6,Gold
3406,3444,7,44,93684,1,2,2,5,Platinum
3407,3445,51,52,123112,2,2,2,6,Gold
3408,3446,21,11,28140,2,4,4,10,Silver
3409,3447,31,15,39090,2,4,4,10,Silver
3410,3448,9,74,72771,1,2,3,6,Gold
3411,3449,29,217,285553,2,1,1,4,Platinum
3412,3450,3,252,1193092,1,1,1,3,Platinum
3413,3451,42,16,100138,2,4,2,8,Gold
3414,3452,12,234,168209,1,1,2,4,Platinum
3415,3453,34,7,11220,2,4,4,10,Silver
3416,3454,49,3,10495,2,4,4,10,Silver
3417,3455,62,9,48318,3,4,3,10,Silver
3418,3456,194,4,21551,4,4,4,12,Bronze
3419,3457,79,153,111790,3,1,2,6,Gold
3420,3458,117,2,86000,3,4,3,10,Silver
3421,3459,64,11,19982,3,4,4,11,Bronze
3422,3460,14,22,50075,1,3,3,7,Gold
3423,3461,87,28,129116,3,3,2,8,Gold
3424,3462,18,30,93708,1,3,2,6,Gold
3425,3463,246,28,53215,4,3,3,10,Silver
3426,3464,88,75,158630,3,2,2,7,Gold
3427,3465,31,22,12923,2,3,4,9,Silver
3428,3466,138,15,51732,3,4,3,10,Silver
3429,3467,27,70,165947,2,2,2,6,Gold
3430,3468,4,98,155405,1,2,2,5,Platinum
3431,3469,33,102,231136,2,1,1,4,Platinum
3432,3470,29,6,112824,2,4,2,8,Gold
3433,3471,114,22,40584,3,3,3,9,Silver
3434,3472,159,22,88420,4,3,2,9,Silver
3435,3473,86,65,137379,3,2,2,7,Gold
3436,3474,119,43,119841,3,2,2,7,Gold
3437,3475,3,318,692783,1,1,1,3,Platinum
3438,3476,97,316,409514,3,1,1,5,Platinum
3439,3477,195,43,33570,4,2,4,10,Silver
3440,3478,29,92,54930,2,2,3,7,Gold
3441,3479,131,13,54478,3,4,3,10,Silver
3442,3480,29,83,178704,2,2,2,6,Gold
3443,3481,82,62,150427,3,2,2,7,Gold
3444,3482,30,516,409403,2,1,1,4,Platinum
3445,3483,269,5,37026,4,4,4,12,Bronze
3446,3484,74,99,598907,3,2,1,6,Gold
3447,3485,314,69,78028,4,2,3,9,Silver
3448,3486,22,78,183705,2,2,2,6,Gold
3449,3487,59,62,99205,3,2,2,7,Gold
3450,3489,14,295,560276,1,1,1,3,Platinum
3451,3490,29,143,348160,2,1,1,4,Platinum
3452,3491,115,64,38214,3,2,4,9,Silver
3453,3492,29,140,302757,2,1,1,4,Platinum
3454,3493,18,173,182424,1,1,2,4,Platinum
3455,3494,18,77,99428,1,2,2,5,Platinum
3456,3495,37,25,98993,2,3,2,7,Gold
3457,3496,37,27,73894,2,3,3,8,Gold
3458,3497,79,2,14148,3,4,4,11,Bronze
3459,3498,24,8,36646,2,4,4,10,Silver
3460,3499,26,64,33075,2,2,4,8,Gold
3461,3500,34,81,242570,2,2,1,5,Platinum
3462,3501,110,52,175036,3,2,2,7,Gold
3463,3502,36,162,371588,2,1,1,4,Platinum
3464,3503,124,187,196484,3,1,2,6,Gold
3465,3504,8,96,302762,1,2,1,4,Platinum
3466,3505,30,115,242485,2,1,1,4,Platinum
3467,3506,7,63,251407,1,2,1,4,Platinum
3468,3507,3,195,475363,1,1,1,3,Platinum
3469,3508,51,125,235181,2,1,1,4,Platinum
3470,3509,323,14,38382,4,4,4,12,Bronze
3471,3510,23,74,163410,2,2,2,6,Gold
3472,3511,20,48,119034,2,2,2,6,Gold
3473,3512,3,211,119323,1,1,2,4,Platinum
3474,3513,19,65,140644,1,2,2,5,Platinum
3475,3514,11,42,201536,1,2,2,5,Platinum
3476,3515,271,1,2738,4,4,4,12,Bronze
3477,3516,160,90,99140,4,2,2,8,Gold
3478,3517,34,418,1332668,2,1,1,4,Platinum
3479,3518,30,117,117848,2,1,2,5,Platinum
3480,3519,166,12,18428,4,4,4,12,Bronze
3481,3520,48,30,36735,2,3,4,9,Silver
3482,3521,6,127,92732,1,1,2,4,Platinum
3483,3522,9,39,102433,1,3,2,6,Gold
3484,3523,289,9,15066,4,4,4,12,Bronze
3485,3524,319,10,21850,4,4,4,12,Bronze
3486,3525,8,35,81677,1,3,3,7,Gold
3487,3526,234,18,38565,4,3,4,11,Bronze
3488,3527,121,7,18804,3,4,4,11,Bronze
3489,3528,163,9,47700,4,4,3,11,Bronze
3490,3529,186,32,36552,4,3,4,11,Bronze
3491,3530,51,40,39776,2,3,3,8,Gold
3492,3531,153,260,135151,4,1,2,7,Gold
3493,3532,335,14,19762,4,4,4,12,Bronze
3494,3533,6,134,293614,1,1,1,3,Platinum
3495,3534,16,26,515344,1,3,1,5,Platinum
3496,3535,107,24,46824,3,3,3,9,Silver
3497,3536,17,52,168425,1,2,2,5,Platinum
3498,3537,276,24,45886,4,3,3,10,Silver
3499,3538,17,478,1309866,1,1,1,3,Platinum
3500,3539,249,20,56833,4,3,3,10,Silver
3501,3540,241,15,62909,4,4,3,11,Bronze
3502,3541,2,48,113009,1,2,2,5,Platinum
3503,3542,108,35,85561,3,3,3,9,Silver
3504,3543,23,81,218152,2,2,1,5,Platinum
3505,3544,53,9,16358,3,4,4,11,Bronze
3506,3545,196,14,191488,4,4,2,10,Silver
3507,3546,25,14,25998,2,4,4,10,Silver
3508,3547,78,23,58420,3,3,3,9,Silver
3509,3548,19,20,34831,1,3,4,8,Gold
3510,3549,14,13,39294,1,4,3,8,Gold
3511,3550,33,67,170044,2,2,2,6,Gold
3512,3551,22,101,212135,2,1,1,4,Platinum
3513,3552,32,229,486928,2,1,1,4,Platinum
3514,3553,29,104,216926,2,1,1,4,Platinum
3515,3554,22,5,32736,2,4,4,10,Silver
3516,3555,33,144,326398,2,1,1,4,Platinum
3517,3556,285,10,20484,4,4,4,12,Bronze
3518,3557,46,12,24506,2,4,4,10,Silver
3519,3558,59,54,111698,3,2,2,7,Gold
3520,3559,290,16,35107,4,4,4,12,Bronze
3521,3560,79,15,47256,3,4,3,10,Silver
3522,3561,6,86,439183,1,2,1,4,Platinum
3523,3562,218,4,8702,4,4,4,12,Bronze
3524,3563,45,63,184750,2,2,2,6,Gold
3525,3564,202,15,39004,4,4,4,12,Bronze
3526,3565,179,80,83655,4,2,3,9,Silver
3527,3566,57,128,108232,3,1,2,6,Gold
3528,3567,58,23,29149,3,3,4,10,Silver
3529,3568,8,73,400692,1,2,1,4,Platinum
3530,3569,55,2,22600,3,4,4,11,Bronze
3531,3570,227,10,27817,4,4,4,12,Bronze
3532,3571,12,84,317315,1,2,1,4,Platinum
3533,3572,107,61,48965,3,2,3,8,Gold
3534,3573,59,19,52570,3,3,3,9,Silver
3535,3574,29,237,269897,2,1,1,4,Platinum
3536,3575,43,32,241808,2,3,1,6,Gold
3537,3576,361,25,30140,4,3,4,11,Bronze
3538,3577,30,29,110989,2,3,2,7,Gold
3539,3578,25,96,89330,2,2,2,6,Gold
3540,3579,54,40,46031,3,3,3,9,Silver
3541,3580,36,152,504079,2,1,1,4,Platinum
3542,3581,176,57,183213,4,2,2,8,Gold
3543,3582,54,13,74236,3,4,3,10,Silver
3544,3583,54,7,25752,3,4,4,11,Bronze
3545,3584,28,211,295510,2,1,1,4,Platinum
3546,3585,257,4,31215,4,4,4,12,Bronze
3547,3586,41,157,333103,2,1,1,4,Platinum
3548,3587,61,103,120134,3,1,2,6,Gold
3549,3588,236,9,12143,4,4,4,12,Bronze
3550,3589,5,274,242206,1,1,1,3,Platinum
3551,3590,32,25,16032,2,3,4,9,Silver
3552,3591,25,472,416700,2,1,1,4,Platinum
3553,3592,8,63,47719,1,2,3,6,Gold
3554,3593,66,28,41781,3,3,3,9,Silver
3555,3594,311,48,44056,4,2,3,9,Silver
3556,3595,309,21,63759,4,3,3,10,Silver
3557,3596,19,47,137124,1,2,2,5,Platinum
3558,3597,16,208,263630,1,1,1,3,Platinum
3559,3598,99,47,40371,3,2,3,8,Gold
3560,3599,269,69,450491,4,2,1,7,Gold
3561,3600,13,541,407936,1,1,1,3,Platinum
3562,3601,3,36,52623,1,3,3,7,Gold
3563,3602,36,25,24284,2,3,4,9,Silver
3564,3603,183,14,17463,4,4,4,12,Bronze
3565,3604,26,29,65579,2,3,3,8,Gold
3566,3605,13,105,111717,1,1,2,4,Platinum
3567,3606,13,19,36692,1,3,4,8,Gold
3568,3607,4,566,466060,1,1,1,3,Platinum
3569,3608,313,15,45688,4,4,3,11,Bronze
3570,3609,109,40,142926,3,3,2,8,Gold
3571,3610,2,399,1037160,1,1,1,3,Platinum
3572,3611,54,31,125059,3,3,2,8,Gold
3573,3612,205,9,20019,4,4,4,12,Bronze
3574,3613,16,55,34357,1,2,4,7,Gold
3575,3614,121,69,41853,3,2,3,8,Gold
3576,3615,4,57,47807,1,2,3,6,Gold
3577,3616,363,39,34116,4,3,4,11,Bronze
3578,3617,120,87,47392,3,2,3,8,Gold
3579,3618,19,18,19687,1,3,4,8,Gold
3580,3619,5,112,41254,1,1,3,5,Platinum
3581,3620,41,78,39523,2,2,3,7,Gold
3582,3621,110,16,34358,3,4,4,11,Bronze
3583,3622,149,124,81337,4,1,3,8,Gold
3584,3623,56,12,142033,3,4,2,9,Silver
3585,3624,209,23,8141,4,3,4,11,Bronze
3586,3625,139,127,75707,3,1,3,7,Gold
3587,3626,3,80,39213,1,2,4,7,Gold
3588,3627,128,38,41086,3,3,3,9,Silver
3589,3628,108,6,119844,3,4,2,9,Silver
3590,3629,43,114,304510,2,1,1,4,Platinum
3591,3630,37,27,15744,2,3,4,9,Silver
3592,3631,228,69,127709,4,2,2,8,Gold
3593,3632,244,15,33496,4,4,4,12,Bronze
3594,3633,61,9,23043,3,4,4,11,Bronze
3595,3634,133,94,294747,3,2,1,6,Gold
3596,3635,62,292,233601,3,1,1,5,Platinum
3597,3636,22,45,21571,2,2,4,8,Gold
3598,3637,27,124,131400,2,1,2,5,Platinum
3599,3638,10,142,205509,1,1,2,4,Platinum
3600,3639,32,111,120701,2,1,2,5,Platinum
3601,3640,4,102,75445,1,1,3,5,Platinum
3602,3641,309,1,59112,4,4,3,11,Bronze
3603,3642,9,135,249529,1,1,1,3,Platinum
3604,3643,29,69,71118,2,2,3,7,Gold
3605,3644,18,51,16299,1,2,4,7,Gold
3606,3645,102,30,70278,3,3,3,9,Silver
3607,3646,18,57,103398,1,2,2,5,Platinum
3608,3647,22,66,27758,2,2,4,8,Gold
3609,3648,15,79,140414,1,2,2,5,Platinum
3610,3649,362,53,31581,4,2,4,10,Silver
3611,3650,11,66,1356806,1,2,1,4,Platinum
3612,3652,96,12,9806,3,4,4,11,Bronze
3613,3653,79,55,186949,3,2,2,7,Gold
3614,3654,139,14,75499,3,4,3,10,Silver
3615,3655,33,24,313280,2,3,1,6,Gold
3616,3656,28,131,359984,2,1,1,4,Platinum
3617,3657,2,470,841631,1,1,1,3,Platinum
3618,3658,50,9,290646,2,4,1,7,Gold
3619,3659,101,73,152076,3,2,2,7,Gold
3620,3660,16,107,87225,1,1,2,4,Platinum
3621,3661,20,199,133804,2,1,2,5,Platinum
3622,3662,18,50,142258,1,2,2,5,Platinum
3623,3663,282,6,11706,4,4,4,12,Bronze
3624,3664,15,33,60680,1,3,3,7,Gold
3625,3665,23,6,39746,2,4,3,9,Silver
3626,3666,128,1,18272,3,4,4,11,Bronze
3627,3667,87,28,64371,3,3,3,9,Silver
3628,3668,303,11,45397,4,4,3,11,Bronze
3629,3669,152,542,268655,4,1,1,6,Gold
3630,3670,18,751,824291,1,1,1,3,Platinum
3631,3671,97,9,32916,3,4,4,11,Bronze
3632,3672,30,407,1542360,2,1,1,4,Platinum
3633,3673,157,183,101195,4,1,2,7,Gold
3634,3674,357,17,21336,4,4,4,12,Bronze
3635,3675,47,32,19825,2,3,4,9,Silver
3636,3676,16,87,71763,1,2,3,6,Gold
3637,3677,4,500,344235,1,1,1,3,Platinum
3638,3678,88,1,41688,3,4,3,10,Silver
3639,3679,15,215,188645,1,1,2,4,Platinum
3640,3680,180,9,21123,4,4,4,12,Bronze
3641,3681,9,71,159811,1,2,2,5,Platinum
3642,3682,38,27,65398,2,3,3,8,Gold
3643,3683,135,8,242700,3,4,1,8,Gold
3644,3684,51,16,201487,2,4,2,8,Gold
3645,3685,312,19,27652,4,3,4,11,Bronze
3646,3686,25,45,46280,2,2,3,7,Gold
3647,3687,304,59,46656,4,2,3,9,Silver
3648,3688,12,15,24518,1,4,4,9,Silver
3649,3689,18,132,74115,1,1,3,5,Platinum
3650,3690,51,29,55733,2,3,3,8,Gold
3651,3691,240,35,43280,4,3,3,10,Silver
3652,3692,1,411,584368,1,1,1,3,Platinum
3653,3693,13,467,724558,1,1,1,3,Platinum
3654,3694,239,34,22543,4,3,4,11,Bronze
3655,3695,24,111,256648,2,1,1,4,Platinum
3656,3696,73,33,68102,3,3,3,9,Silver
3657,3697,18,87,48715,1,2,3,6,Gold
3658,3698,41,253,170867,2,1,2,5,Platinum
3659,3699,41,57,82826,2,2,3,7,Gold
3660,3700,219,28,52202,4,3,3,10,Silver
3661,3701,200,69,58777,4,2,3,9,Silver
3662,3702,71,24,25873,3,3,4,10,Silver
3663,3703,24,418,506161,2,1,1,4,Platinum
3664,3704,12,83,74134,1,2,3,6,Gold
3665,3705,13,104,2807937,1,1,1,3,Platinum
3666,3706,69,2,6640,3,4,4,11,Bronze
3667,3707,5,51,26550,1,2,4,7,Gold
3668,3708,20,15,38752,2,4,4,10,Silver
3669,3709,15,47,36876,1,2,4,7,Gold
3670,3710,9,27,262856,1,3,1,5,Platinum
3671,3711,20,78,105270,2,2,2,6,Gold
3672,3712,79,15,164928,3,4,2,9,Silver
3673,3713,3,211,3340666,1,1,1,3,Platinum
3674,3714,168,3,57024,4,4,3,11,Bronze
3675,3715,307,61,63483,4,2,3,9,Silver
3676,3716,220,4,22803,4,4,4,12,Bronze
3677,3717,45,25,689718,2,3,1,6,Gold
3678,3718,23,92,82670,2,2,3,7,Gold
3679,3719,115,38,79589,3,3,3,9,Silver
3680,3720,127,213,273980,3,1,1,5,Platinum
3681,3721,11,58,302485,1,2,1,4,Platinum
3682,3722,37,33,33556,2,3,4,9,Silver
3683,3723,7,191,4443946,1,1,1,3,Platinum
3684,3724,2,82,141636,1,2,2,5,Platinum
3685,3725,334,113,258178,4,1,1,6,Gold
3686,3726,167,2,3423,4,4,4,12,Bronze
3687,3727,185,13,81568,4,4,3,11,Bronze
3688,3728,17,64,151807,1,2,2,5,Platinum
3689,3729,13,41,98366,1,3,2,6,Gold
3690,3730,4,66,161808,1,2,2,5,Platinum
3691,3731,45,6,141440,2,4,2,8,Gold
3692,3732,81,14,55861,3,4,3,10,Silver
3693,3733,30,269,910615,2,1,1,4,Platinum
3694,3734,43,30,61055,2,3,3,8,Gold
3695,3735,14,206,517006,1,1,1,3,Platinum
3696,3736,51,30,72000,2,3,3,8,Gold
3697,3737,17,117,317801,1,1,1,3,Platinum
3698,3738,47,26,88053,2,3,2,7,Gold
3699,3739,27,43,98938,2,2,2,6,Gold
3700,3740,9,271,670280,1,1,1,3,Platinum
3701,3741,81,2,13378,3,4,4,11,Bronze
3702,3742,5,328,2192731,1,1,1,3,Platinum
3703,3743,129,39,80325,3,3,3,9,Silver
3704,3744,33,14,32542,2,4,4,10,Silver
3705,3745,314,43,56539,4,2,3,9,Silver
3706,3746,19,48,49338,1,2,3,6,Gold
3707,3747,89,54,40925,3,2,3,8,Gold
3708,3748,3,134,328568,1,1,1,3,Platinum
3709,3749,3,9,26970,1,4,4,9,Silver
3710,3750,255,17,44414,4,4,3,11,Bronze
3711,3751,162,5,22284,4,4,4,12,Bronze
3712,3752,37,135,290569,2,1,1,4,Platinum
3713,3754,152,134,348584,4,1,1,6,Gold
3714,3755,177,9,21642,4,4,4,12,Bronze
3715,3756,41,36,77671,2,3,3,8,Gold
3716,3758,3,276,307562,1,1,1,3,Platinum
3717,3759,10,261,7557847,1,1,1,3,Platinum
3718,3760,2,100,232651,1,2,1,4,Platinum
3719,3761,18,19,62926,1,3,3,7,Gold
3720,3762,195,61,63296,4,2,3,9,Silver
3721,3763,204,8,15650,4,4,4,12,Bronze
3722,3764,366,17,34814,4,4,4,12,Bronze
3723,3765,128,19,216890,3,3,1,7,Gold
3724,3766,16,54,40327,1,2,3,6,Gold
3725,3767,44,111,91128,2,1,2,5,Platinum
3726,3768,96,29,74624,3,3,3,9,Silver
3727,3769,23,111,116949,2,1,2,5,Platinum
3728,3770,61,27,78092,3,3,3,9,Silver
3729,3771,18,215,247934,1,1,1,3,Platinum
3730,3772,159,9,46897,4,4,3,11,Bronze
3731,3773,11,41,95431,1,3,2,6,Gold
3732,3774,15,5,15756,1,4,4,9,Silver
3733,3775,17,88,225558,1,2,1,4,Platinum
3734,3776,45,78,202938,2,2,2,6,Gold
3735,3777,192,181,95263,4,1,2,7,Gold
3736,3778,80,14,30130,3,4,4,11,Bronze
3737,3779,78,29,70850,3,3,3,9,Silver
3738,3780,4,82,180467,1,2,2,5,Platinum
3739,3781,68,21,50163,3,3,3,9,Silver
3740,3782,262,24,49484,4,3,3,10,Silver
3741,3783,59,29,56580,3,3,3,9,Silver
3742,3784,1,76,267858,1,2,1,4,Platinum
3743,3785,2,109,455314,1,1,1,3,Platinum
3744,3786,249,12,46069,4,4,3,11,Bronze
3745,3787,10,27,62453,1,3,3,7,Gold
3746,3788,359,10,31214,4,4,4,12,Bronze
3747,3789,76,17,42378,3,4,3,10,Silver
3748,3790,290,40,92281,4,3,2,9,Silver
3749,3791,26,5,114734,2,4,2,8,Gold
3750,3792,221,18,36953,4,3,4,11,Bronze
3751,3793,10,28,88424,1,3,2,6,Gold
3752,3794,3,38,79670,1,3,3,7,Gold
3753,3795,208,127,387076,4,1,1,6,Gold
3754,3796,162,52,145928,4,2,2,8,Gold
3755,3797,76,14,38046,3,4,4,11,Bronze
3756,3798,262,88,76044,4,2,3,9,Silver
3757,3799,281,22,53444,4,3,3,10,Silver
3758,3800,58,366,791817,3,1,1,5,Platinum
3759,3801,25,20,42820,2,3,3,8,Gold
3760,3802,3,963,12367652,1,1,1,3,Platinum
3761,3803,29,105,440884,2,1,1,4,Platinum
3762,3804,74,6,65128,3,4,3,10,Silver
3763,3805,129,40,26851,3,3,4,10,Silver
3764,3806,35,87,76076,2,2,3,7,Gold
3765,3807,16,137,99181,1,1,2,4,Platinum
3766,3808,309,11,21042,4,4,4,12,Bronze
3767,3809,18,82,249325,1,2,1,4,Platinum
3768,3810,54,30,74205,3,3,3,9,Silver
3769,3811,31,45,97999,2,2,2,6,Gold
3770,3812,2,72,155533,1,2,2,5,Platinum
3771,3813,12,33,110200,1,3,2,6,Gold
3772,3814,362,6,18656,4,4,4,12,Bronze
3773,3815,360,9,46602,4,4,3,11,Bronze
3774,3816,5,19,133135,1,3,2,6,Gold
3775,3817,54,47,117221,3,2,2,7,Gold
3776,3818,2,253,475033,1,1,1,3,Platinum
3777,3819,2,392,315213,1,1,1,3,Platinum
3778,3820,191,14,37230,4,4,4,12,Bronze
3779,3821,54,9,27219,3,4,4,11,Bronze
3780,3822,284,13,24302,4,4,4,12,Bronze
3781,3823,180,3,8084,4,4,4,12,Bronze
3782,3824,30,75,126330,2,2,2,6,Gold
3783,3825,27,9,18342,2,4,4,10,Silver
3784,3826,25,25,69531,2,3,3,8,Gold
3785,3827,270,25,23474,4,3,4,11,Bronze
3786,3828,44,144,82660,2,1,3,6,Gold
3787,3830,235,5,12148,4,4,4,12,Bronze
3788,3831,26,6,25926,2,4,4,10,Silver
3789,3832,198,42,30599,4,2,4,10,Silver
3790,3833,360,43,38054,4,2,4,10,Silver
3791,3834,65,49,128823,3,2,2,7,Gold
3792,3835,130,1,25632,3,4,4,11,Bronze
3793,3836,2,88,295511,1,2,1,4,Platinum
3794,3837,20,106,66667,2,1,3,6,Gold
3795,3838,206,6,22664,4,4,4,12,Bronze
3796,3839,16,34,66002,1,3,3,7,Gold
3797,3840,95,27,115861,3,3,2,8,Gold
3798,3841,20,46,24248,2,2,4,8,Gold
3799,3842,15,63,155685,1,2,2,5,Platinum
3800,3843,25,49,52998,2,2,3,7,Gold
3801,3844,9,152,114667,1,1,2,4,Platinum
3802,3845,8,165,566556,1,1,1,3,Platinum
3803,3846,333,29,42548,4,3,3,10,Silver
3804,3847,51,298,194425,2,1,2,5,Platinum
3805,3848,72,12,27628,3,4,4,11,Bronze
3806,3849,30,25,52085,2,3,3,8,Gold
3807,3850,244,8,22712,4,4,4,12,Bronze
3808,3851,9,411,461028,1,1,1,3,Platinum
3809,3852,219,5,17862,4,4,4,12,Bronze
3810,3853,6,50,56123,1,2,3,6,Gold
3811,3854,259,44,25201,4,2,4,10,Silver
3812,3855,1,440,1403941,1,1,1,3,Platinum
3813,3856,237,29,24992,4,3,4,11,Bronze
3814,3857,8,35,149918,1,3,2,6,Gold
3815,3858,110,214,195492,3,1,2,6,Gold
3816,3859,102,23,156106,3,3,2,8,Gold
3817,3860,61,252,322560,3,1,1,5,Platinum
3818,3861,3,200,185690,1,1,2,4,Platinum
3819,3862,75,166,277511,3,1,1,5,Platinum
3820,3863,4,213,544573,1,1,1,3,Platinum
3821,3864,86,50,123126,3,2,2,7,Gold
3822,3865,13,83,51622,1,2,3,6,Gold
3823,3866,24,270,486410,2,1,1,4,Platinum
3824,3867,214,55,250461,4,2,1,7,Gold
3825,3868,19,13,20562,1,4,4,9,Silver
3826,3869,240,9,18499,4,4,4,12,Bronze
3827,3870,3,560,715431,1,1,1,3,Platinum
3828,3871,79,11,44346,3,4,3,10,Silver
3829,3872,218,63,40635,4,2,3,9,Silver
3830,3873,34,59,30092,2,2,4,8,Gold
3831,3874,41,235,146839,2,1,2,5,Platinum
3832,3875,8,576,523893,1,1,1,3,Platinum
3833,3876,54,135,298408,3,1,1,5,Platinum
3834,3877,23,312,570428,2,1,1,4,Platinum
3835,3878,58,100,50586,3,2,3,8,Gold
3836,3879,137,14,40075,3,4,3,10,Silver
3837,3880,183,3,68672,4,4,3,11,Bronze
3838,3881,6,78,111199,1,2,2,5,Platinum
3839,3882,313,77,28476,4,2,4,10,Silver
3840,3883,60,4,9600,3,4,4,11,Bronze
3841,3884,22,26,163604,2,3,2,7,Gold
3842,3885,33,33,68301,2,3,3,8,Gold
3843,3886,15,50,117884,1,2,2,5,Platinum
3844,3887,19,315,270048,1,1,1,3,Platinum
3845,3888,83,5,10681,3,4,4,11,Bronze
3846,3889,6,123,257684,1,1,1,3,Platinum
3847,3890,170,26,59408,4,3,3,10,Silver
3848,3891,2,39,68693,1,3,3,7,Gold
3849,3892,34,70,169926,2,2,2,6,Gold
3850,3893,37,297,279899,2,1,1,4,Platinum
3851,3894,20,20,39362,2,3,3,8,Gold
3852,3895,32,35,70043,2,3,3,8,Gold
3853,3896,277,7,15066,4,4,4,12,Bronze
3854,3897,87,5,73764,3,4,3,10,Silver
3855,3898,120,40,96992,3,3,2,8,Gold
3856,3899,374,8,14194,4,4,4,12,Bronze
3857,3900,2,157,387912,1,1,1,3,Platinum
3858,3901,220,51,118212,4,2,2,8,Gold
3859,3902,66,7,14801,3,4,4,11,Bronze
3860,3903,61,91,207468,3,2,2,7,Gold
3861,3904,139,52,107799,3,2,2,7,Gold
3862,3905,23,8,22350,2,4,4,10,Silver
3863,3906,12,232,550659,1,1,1,3,Platinum
3864,3907,26,259,614449,2,1,1,4,Platinum
3865,3908,39,44,166861,2,2,2,6,Gold
3866,3909,278,22,13290,4,3,4,11,Bronze
3867,3910,11,91,313107,1,2,1,4,Platinum
3868,3911,74,82,239199,3,2,1,6,Gold
3869,3912,26,19,102686,2,3,2,7,Gold
3870,3913,18,158,375201,1,1,1,3,Platinum
3871,3914,142,45,25600,3,2,4,9,Silver
3872,3915,26,86,224544,2,2,1,5,Platinum
3873,3916,19,43,90555,1,2,2,5,Platinum
3874,3917,5,18,103668,1,3,2,6,Gold
3875,3918,67,117,255356,3,1,1,5,Platinum
3876,3919,2,15,40044,1,4,3,8,Gold
3877,3920,43,68,434140,2,2,1,5,Platinum
3878,3921,228,11,26042,4,4,4,12,Bronze
3879,3922,17,53,193542,1,2,2,5,Platinum
3880,3923,51,110,400463,2,1,1,4,Platinum
3881,3924,2,227,241555,1,1,1,3,Platinum
3882,3925,75,27,93470,3,3,2,8,Gold
3883,3926,2,705,2454795,1,1,1,3,Platinum
3884,3927,5,78,188788,1,2,2,5,Platinum
3885,3928,2,304,2164906,1,1,1,3,Platinum
3886,3929,264,16,37982,4,4,4,12,Bronze
3887,3930,55,30,226647,3,3,1,7,Gold
3888,3931,25,11,24248,2,4,4,10,Silver
3889,3932,11,118,323873,1,1,1,3,Platinum
3890,3933,44,15,32961,2,4,4,10,Silver
3891,3934,17,130,406613,1,1,1,3,Platinum
3892,3935,8,286,704126,1,1,1,3,Platinum
3893,3936,32,256,561697,2,1,1,4,Platinum
3894,3937,360,19,35218,4,3,4,11,Bronze
3895,3938,128,45,102180,3,2,2,7,Gold
3896,3939,138,16,35194,3,4,4,11,Bronze
3897,3940,142,15,37494,3,4,4,11,Bronze
3898,3941,133,35,116128,3,3,2,8,Gold
3899,3942,39,115,322182,2,1,1,4,Platinum
3900,3943,237,19,39956,4,3,3,10,Silver
3901,3944,261,8,17985,4,4,4,12,Bronze
3902,3945,17,142,307925,1,1,1,3,Platinum
3903,3946,253,24,47314,4,3,3,10,Silver
3904,3947,31,74,257929,2,2,1,5,Platinum
3905,3948,36,55,106784,2,2,2,6,Gold
3906,3949,169,31,110221,4,3,2,9,Silver
3907,3950,5,103,229524,1,1,1,3,Platinum
3908,3951,5,382,1256291,1,1,1,3,Platinum
3909,3952,193,5,22980,4,4,4,12,Bronze
3910,3953,188,35,31905,4,3,4,11,Bronze
3911,3954,170,7,14389,4,4,4,12,Bronze
3912,3955,11,23,52949,1,3,3,7,Gold
3913,3956,45,29,65645,2,3,3,8,Gold
3914,3957,321,10,19482,4,4,4,12,Bronze
3915,3958,205,1,39552,4,4,3,11,Bronze
3916,3959,23,245,725207,2,1,1,4,Platinum
3917,3960,234,6,16279,4,4,4,12,Bronze
3918,3961,38,274,668855,2,1,1,4,Platinum
3919,3962,27,50,153292,2,2,2,6,Gold
3920,3963,97,115,310863,3,1,1,5,Platinum
3921,3964,129,10,363126,3,4,1,8,Gold
3922,3965,74,40,118826,3,3,2,8,Gold
3923,3966,17,192,451276,1,1,1,3,Platinum
3924,3967,16,66,143286,1,2,2,5,Platinum
3925,3968,5,165,359780,1,1,1,3,Platinum
3926,3969,4,218,718602,1,1,1,3,Platinum
3927,3970,80,67,146834,3,2,2,7,Gold
3928,3971,373,18,34924,4,3,4,11,Bronze
3929,3972,39,35,92279,2,3,2,7,Gold
3930,3973,54,43,94571,3,2,2,7,Gold
3931,3974,3,690,1741880,1,1,1,3,Platinum
3932,3975,12,25,49765,1,3,3,7,Gold
3933,3976,11,10,20859,1,4,4,9,Silver
3934,3977,20,97,243040,2,2,1,5,Platinum
3935,3978,17,47,329048,1,2,1,4,Platinum
3936,3979,120,15,40499,3,4,3,10,Silver
3937,3980,4,136,415866,1,1,1,3,Platinum
3938,3981,243,6,12560,4,4,4,12,Bronze
3939,3982,121,1,7164,3,4,4,11,Bronze
3940,3983,179,35,83694,4,3,3,10,Silver
3941,3984,6,190,376828,1,1,1,3,Platinum
3942,3985,363,1,18048,4,4,4,12,Bronze
3943,3986,1,92,277629,1,2,1,4,Platinum
3944,3987,2,740,726525,1,1,1,3,Platinum
3945,3988,20,412,449940,2,1,1,4,Platinum
3946,3989,18,94,126491,1,2,2,5,Platinum
3947,3990,22,25,40530,2,3,3,8,Gold
3948,3991,33,19,87961,2,3,2,7,Gold
3949,3992,266,1,1800,4,4,4,12,Bronze
3950,3993,51,75,101270,2,2,2,6,Gold
3951,3994,159,57,43617,4,2,3,9,Silver
3952,3995,17,21,34882,1,3,4,8,Gold
3953,3996,9,105,281793,1,1,1,3,Platinum
3954,3997,13,310,489644,1,1,1,3,Platinum
3955,3998,200,38,127685,4,3,2,9,Silver
3956,3999,57,53,42435,3,2,3,8,Gold
3957,4000,11,53,21215,1,2,4,7,Gold
3958,4001,97,156,152238,3,1,2,6,Gold
3959,4002,256,3,8400,4,4,4,12,Bronze
3960,4003,25,194,93980,2,1,2,5,Platinum
3961,4004,22,82,86564,2,2,2,6,Gold
3962,4005,161,12,20827,4,4,4,12,Bronze
3963,4006,73,67,46934,3,2,3,8,Gold
3964,4007,54,13,16780,3,4,4,11,Bronze
3965,4008,86,72,36660,3,2,4,9,Silver
3966,4009,153,134,240653,4,1,1,6,Gold
3967,4010,76,4,119191,3,4,2,9,Silver
3968,4011,282,14,27096,4,4,4,12,Bronze
3969,4012,27,190,242911,2,1,1,4,Platinum
3970,4013,31,10,12933,2,4,4,10,Silver
3971,4014,26,58,46409,2,2,3,7,Gold
3972,4015,180,46,54095,4,2,3,9,Silver
3973,4016,45,82,78482,2,2,3,7,Gold
3974,4017,23,111,100470,2,1,2,5,Platinum
3975,4018,23,408,401290,2,1,1,4,Platinum
3976,4019,38,103,159222,2,1,2,5,Platinum
3977,4020,83,140,164340,3,1,2,6,Gold
3978,4021,75,10,59569,3,4,3,10,Silver
3979,4022,12,43,93687,1,2,2,5,Platinum
3980,4023,18,61,621770,1,2,1,4,Platinum
3981,4024,5,850,976902,1,1,1,3,Platinum
3982,4025,13,141,92923,1,1,2,4,Platinum
3983,4026,15,371,216627,1,1,1,3,Platinum
3984,4027,40,17,5190,2,4,4,10,Silver
3985,4028,5,33,42564,1,3,3,7,Gold
3986,4029,81,48,430037,3,2,1,6,Gold
3987,4031,53,13,57648,3,4,3,10,Silver
3988,4032,6,220,261362,1,1,1,3,Platinum
3989,4033,23,64,152733,2,2,2,6,Gold
3990,4034,299,30,109640,4,3,2,9,Silver
3991,4035,3,23,44025,1,3,3,7,Gold
3992,4036,35,2,4116,2,4,4,10,Silver
3993,4037,50,61,25546,2,2,4,8,Gold
3994,4038,3,61,53399,1,2,3,6,Gold
3995,4039,48,23,14644,2,3,4,9,Silver
3996,4040,43,168,184031,2,1,2,5,Platinum
3997,4041,27,121,370713,2,1,1,4,Platinum
3998,4042,43,56,45910,2,2,3,7,Gold
3999,4043,2,7837,5225317,1,1,1,3,Platinum
4000,4044,304,35,24489,4,3,4,11,Bronze
4001,4045,111,5,8056,3,4,4,11,Bronze
4002,4047,86,51,113776,3,2,2,7,Gold
4003,4048,219,26,69052,4,3,3,10,Silver
4004,4049,373,297,628496,4,1,1,6,Gold
4005,4050,12,24,14109,1,3,4,8,Gold
4006,4051,188,15,35090,4,4,4,12,Bronze
4007,4052,373,17,28636,4,4,4,12,Bronze
4008,4053,6,15,194506,1,4,2,7,Gold
4009,4054,9,34,1386946,1,3,1,5,Platinum
4010,4055,6,199,676906,1,1,1,3,Platinum
4011,4056,305,25,21605,4,3,4,11,Bronze
4012,4057,369,58,29949,4,2,4,10,Silver
4013,4058,4,222,301822,1,1,1,3,Platinum
4014,4059,324,11,38352,4,4,4,12,Bronze
4015,4060,60,148,461480,3,1,1,5,Platinum
4016,4061,13,102,102530,1,1,2,4,Platinum
4017,4062,31,369,1345788,2,1,1,4,Platinum
4018,4063,143,9,43654,3,4,3,10,Silver
4019,4064,31,79,152653,2,2,2,6,Gold
4020,4065,109,40,48614,3,3,3,9,Silver
4021,4066,3,279,256897,1,1,1,3,Platinum
4022,4067,205,10,24648,4,4,4,12,Bronze
4023,4068,81,43,221032,3,2,1,6,Gold
4024,4069,187,46,79788,4,2,3,9,Silver
4025,4070,172,12,29911,4,4,4,12,Bronze
4026,4071,44,26,58412,2,3,3,8,Gold
4027,4072,174,6,20151,4,4,4,12,Bronze
4028,4073,367,26,63664,4,3,3,10,Silver
4029,4074,306,8,15741,4,4,4,12,Bronze
4030,4075,4,145,87399,1,1,2,4,Platinum
4031,4076,4,117,112751,1,1,2,4,Platinum
4032,4077,13,64,27487,1,2,4,7,Gold
4033,4078,32,109,111110,2,1,2,5,Platinum
4034,4079,131,10,12435,3,4,4,11,Bronze
4035,4080,23,67,130529,2,2,2,6,Gold
4036,4081,214,21,25513,4,3,4,11,Bronze
4037,4082,323,94,81596,4,2,3,9,Silver
4038,4083,163,34,38051,4,3,4,11,Bronze
4039,4084,59,28,32656,3,3,4,10,Silver
4040,4085,226,16,23059,4,4,4,12,Bronze
4041,4086,72,192,130755,3,1,2,6,Gold
4042,4087,45,16,16803,2,4,4,10,Silver
4043,4088,25,2,41760,2,4,3,9,Silver
4044,4089,173,114,68370,4,1,3,8,Gold
4045,4090,86,28,24612,3,3,4,10,Silver
4046,4091,160,32,24860,4,3,4,11,Bronze
4047,4092,191,6,16165,4,4,4,12,Bronze
4048,4093,30,19,12220,2,3,4,9,Silver
4049,4094,22,38,22742,2,3,4,9,Silver
4050,4095,77,34,97413,3,3,2,8,Gold
4051,4096,248,12,8578,4,4,4,12,Bronze
4052,4097,374,58,33007,4,2,4,10,Silver
4053,4098,10,39,50843,1,3,3,7,Gold
4054,4099,313,38,40026,4,3,3,10,Silver
4055,4100,59,59,59663,3,2,3,8,Gold
4056,4101,4,80,52241,1,2,3,6,Gold
4057,4102,46,94,43080,2,2,3,7,Gold
4058,4103,89,23,174132,3,3,2,8,Gold
4059,4104,5,695,532472,1,1,1,3,Platinum
4060,4105,65,145,101555,3,1,2,6,Gold
4061,4106,283,1,21600,4,4,4,12,Bronze
4062,4107,14,31,353884,1,3,1,5,Platinum
4063,4108,375,1,28584,4,4,4,12,Bronze
4064,4109,134,21,57814,3,3,3,9,Silver
4065,4110,47,22,22086,2,3,4,9,Silver
4066,4111,14,5,87986,1,4,2,7,Gold
4067,4112,36,39,242971,2,3,1,6,Gold
4068,4113,135,65,56352,3,2,3,8,Gold
4069,4114,31,90,166990,2,2,2,6,Gold
4070,4115,57,21,98247,3,3,2,8,Gold
4071,4116,141,28,17364,3,3,4,10,Silver
4072,4117,6,77,50415,1,2,3,6,Gold
4073,4118,11,43,519784,1,2,1,4,Platinum
4074,4119,160,12,12599,4,4,4,12,Bronze
4075,4120,55,17,529598,3,4,1,8,Gold
4076,4121,133,2,38976,3,4,4,11,Bronze
4077,4122,16,2,10948,1,4,4,9,Silver
4078,4123,234,20,19263,4,3,4,11,Bronze
4079,4124,40,9,27772,2,4,4,10,Silver
4080,4125,148,1,43632,4,4,3,11,Bronze
4081,4126,9,34,1453359,1,3,1,5,Platinum
4082,4127,73,71,67670,3,2,3,8,Gold
4083,4128,40,20,125906,2,3,2,7,Gold
4084,4129,6,485,333557,1,1,1,3,Platinum
4085,4130,201,19,76010,4,3,3,10,Silver
4086,4131,250,1,1339,4,4,4,12,Bronze
4087,4132,68,30,27737,3,3,4,10,Silver
4088,4133,117,7,54596,3,4,3,10,Silver
4089,4134,172,26,9646,4,3,4,11,Bronze
4090,4135,26,249,159439,2,1,2,5,Platinum
4091,4136,143,35,16813,3,3,4,10,Silver
4092,4137,32,104,59530,2,1,3,6,Gold
4093,4138,38,329,337614,2,1,1,4,Platinum
4094,4139,41,68,223798,2,2,1,5,Platinum
4095,4140,372,48,15607,4,2,4,10,Silver
4096,4141,374,85,35406,4,2,4,10,Silver
4097,4142,167,14,26572,4,4,4,12,Bronze
4098,4143,212,31,91655,4,3,2,9,Silver
4099,4144,242,31,15456,4,3,4,11,Bronze
4100,4145,52,15,42050,2,4,3,9,Silver
4101,4146,25,179,96525,2,1,2,5,Platinum
4102,4147,16,295,527431,1,1,1,3,Platinum
4103,4148,373,65,40567,4,2,3,9,Silver
4104,4149,30,21,48845,2,3,3,8,Gold
4105,4150,366,12,43618,4,4,3,11,Bronze
4106,4151,36,145,94073,2,1,2,5,Platinum
4107,4152,166,30,126434,4,3,2,9,Silver
4108,4153,146,48,19817,4,2,4,10,Silver
4109,4154,23,23,72051,2,3,3,8,Gold
4110,4155,66,1,2580,3,4,4,11,Bronze
4111,4156,188,13,32105,4,4,4,12,Bronze
4112,4157,14,38,22491,1,3,4,8,Gold
4113,4158,237,29,82070,4,3,3,10,Silver
4114,4159,227,5,10042,4,4,4,12,Bronze
4115,4160,123,81,91833,3,2,2,7,Gold
4116,4161,284,2,20327,4,4,4,12,Bronze
4117,4162,75,166,318832,3,1,1,5,Platinum
4118,4163,38,93,50431,2,2,3,7,Gold
4119,4164,15,58,65468,1,2,3,6,Gold
4120,4165,363,40,20425,4,3,4,11,Bronze
4121,4166,4,60,29991,1,2,4,7,Gold
4122,4167,24,22,49659,2,3,3,8,Gold
4123,4168,71,30,276938,3,3,1,7,Gold
4124,4169,236,32,32603,4,3,4,11,Bronze
4125,4170,257,14,21562,4,4,4,12,Bronze
4126,4171,374,28,13417,4,3,4,11,Bronze
4127,4172,156,31,31322,4,3,4,11,Bronze
4128,4173,29,31,19864,2,3,4,9,Silver
4129,4174,5,46,19647,1,2,4,7,Gold
4130,4175,33,123,192840,2,1,2,5,Platinum
4131,4176,88,3,71200,3,4,3,10,Silver
4132,4177,109,29,14122,3,3,4,10,Silver
4133,4178,52,5,4221,2,4,4,10,Silver
4134,4179,36,191,106879,2,1,2,5,Platinum
4135,4180,153,21,48809,4,3,3,10,Silver
4136,4181,99,21,14054,3,3,4,10,Silver
4137,4182,6,9,26761,1,4,4,9,Silver
4138,4183,337,5,9834,4,4,4,12,Bronze
4139,4184,66,34,17244,3,3,4,10,Silver
4140,4185,22,112,67346,2,1,3,6,Gold
4141,4186,36,53,102388,2,2,2,6,Gold
4142,4187,33,96,52086,2,2,3,7,Gold
4143,4188,155,19,8013,4,3,4,11,Bronze
4144,4189,21,19,45323,2,3,3,8,Gold
4145,4190,12,472,606827,1,1,1,3,Platinum
4146,4191,54,7,17526,3,4,4,11,Bronze
4147,4192,25,121,70219,2,1,3,6,Gold
4148,4193,5,127,255557,1,1,1,3,Platinum
4149,4194,46,47,27159,2,2,4,8,Gold
4150,4195,205,7,22128,4,4,4,12,Bronze
4151,4196,360,5,9554,4,4,4,12,Bronze
4152,4197,72,20,42074,3,3,3,9,Silver
4153,4198,8,360,810639,1,1,1,3,Platinum
4154,4199,289,19,48944,4,3,3,10,Silver
4155,4200,12,3,19696,1,4,4,9,Silver
4156,4201,25,19,45378,2,3,3,8,Gold
4157,4202,23,46,262679,2,2,1,5,Platinum
4158,4203,179,27,92791,4,3,2,9,Silver
4159,4204,134,7,100126,3,4,2,9,Silver
4160,4205,6,137,293642,1,1,1,3,Platinum
4161,4206,76,10,37070,3,4,4,11,Bronze
4162,4207,41,37,48945,2,3,3,8,Gold
4163,4208,293,1,10716,4,4,4,12,Bronze
4164,4209,27,470,275736,2,1,1,4,Platinum
4165,4210,258,25,54812,4,3,3,10,Silver
4166,4211,186,18,39948,4,3,3,10,Silver
4167,4212,118,73,553250,3,2,1,6,Gold
4168,4213,374,13,59355,4,4,3,11,Bronze
4169,4214,24,142,334777,2,1,1,4,Platinum
4170,4215,9,227,359266,1,1,1,3,Platinum
4171,4216,218,29,39746,4,3,3,10,Silver
4172,4217,46,127,762292,2,1,1,4,Platinum
4173,4218,23,1,59592,2,4,3,9,Silver
4174,4219,39,17,44410,2,4,3,9,Silver
4175,4220,26,73,98389,2,2,2,6,Gold
4176,4221,22,1,18096,2,4,4,10,Silver
4177,4222,331,29,77731,4,3,3,10,Silver
4178,4223,275,7,15220,4,4,4,12,Bronze
4179,4225,62,39,23326,3,3,4,10,Silver
4180,4226,4,89,1092498,1,2,1,4,Platinum
4181,4227,94,36,274068,3,3,1,7,Gold
4182,4228,82,70,397510,3,2,1,6,Gold
4183,4229,313,21,76805,4,3,3,10,Silver
4184,4230,12,213,124422,1,1,2,4,Platinum
4185,4231,8,108,347988,1,1,1,3,Platinum
4186,4232,128,19,22579,3,3,4,10,Silver
4187,4233,12,41,26205,1,3,4,8,Gold
4188,4234,3,322,10654918,1,1,1,3,Platinum
4189,4235,38,38,93386,2,3,2,7,Gold
4190,4236,38,18,13474,2,3,4,9,Silver
4191,4237,330,39,49084,4,3,3,10,Silver
4192,4238,255,17,30632,4,4,4,12,Bronze
4193,4239,2,444,1022575,1,1,1,3,Platinum
4194,4240,20,46,27100,2,2,4,8,Gold
4195,4241,13,26,46376,1,3,3,7,Gold
4196,4242,375,1,10080,4,4,4,12,Bronze
4197,4243,291,28,24197,4,3,4,11,Bronze
4198,4244,69,377,178366,3,1,2,6,Gold
4199,4245,26,73,61774,2,2,3,7,Gold
4200,4246,11,1278,714700,1,1,1,3,Platinum
4201,4247,368,30,22364,4,3,4,11,Bronze
4202,4248,215,17,13030,4,4,4,12,Bronze
4203,4249,152,32,92731,4,3,2,9,Silver
4204,4250,9,362,244954,1,1,1,3,Platinum
4205,4251,25,36,88386,2,3,2,7,Gold
4206,4252,30,196,147813,2,1,2,5,Platinum
4207,4253,61,55,27709,3,2,4,9,Silver
4208,4254,20,47,43601,2,2,3,7,Gold
4209,4255,244,14,13871,4,4,4,12,Bronze
4210,4256,16,70,144964,1,2,2,5,Platinum
4211,4258,33,20,79473,2,3,3,8,Gold
4212,4259,66,38,97736,3,3,2,8,Gold
4213,4260,297,8,17888,4,4,4,12,Bronze
4214,4261,18,159,1145182,1,1,1,3,Platinum
4215,4263,158,15,163460,4,4,2,10,Silver
4216,4264,117,61,126415,3,2,2,7,Gold
4217,4265,8,43,372376,1,2,1,4,Platinum
4218,4266,13,221,418853,1,1,1,3,Platinum
4219,4267,144,10,25569,4,4,4,12,Bronze
4220,4268,46,7,27904,2,4,4,10,Silver
4221,4269,51,16,76835,2,4,3,9,Silver
4222,4270,34,37,73054,2,3,3,8,Gold
4223,4271,135,38,80538,3,3,3,9,Silver
4224,4272,4,21,55462,1,3,3,7,Gold
4225,4273,76,25,51143,3,3,3,9,Silver
4226,4274,13,140,89448,1,1,2,4,Platinum
4227,4275,10,34,65488,1,3,3,7,Gold
4228,4276,302,23,59479,4,3,3,10,Silver
4229,4277,58,39,78931,3,3,3,9,Silver
4230,4278,16,80,206298,1,2,2,5,Platinum
4231,4279,38,24,48937,2,3,3,8,Gold
4232,4280,179,10,41252,4,4,3,11,Bronze
4233,4281,24,37,156596,2,3,2,7,Gold
4234,4282,177,131,150351,4,1,2,7,Gold
4235,4283,62,9,24160,3,4,4,11,Bronze
4236,4284,37,38,116519,2,3,2,7,Gold
4237,4285,60,54,146560,3,2,2,7,Gold
4238,4286,18,189,899996,1,1,1,3,Platinum
4239,4287,87,31,276968,3,3,1,7,Gold
4240,4288,11,1,14750,1,4,4,9,Silver
4241,4289,359,30,58877,4,3,3,10,Silver
4242,4290,33,74,168340,2,2,2,6,Gold
4243,4291,129,97,212526,3,2,1,6,Gold
4244,4292,10,90,252565,1,2,1,4,Platinum
4245,4293,5,119,265717,1,1,1,3,Platinum
4246,4294,25,44,44778,2,2,3,7,Gold
4247,4295,228,37,88021,4,3,2,9,Silver
4248,4296,25,1,6360,2,4,4,10,Silver
4249,4297,250,17,37002,4,4,4,12,Bronze
4250,4298,16,71,267904,1,2,1,4,Platinum
4251,4299,78,68,134042,3,2,2,7,Gold
4252,4300,194,15,36670,4,4,4,12,Bronze
4253,4301,263,7,29204,4,4,4,12,Bronze
4254,4302,72,45,111989,3,2,2,7,Gold
4255,4303,166,16,29827,4,4,4,12,Bronze
4256,4304,84,7,127096,3,4,2,9,Silver
4257,4305,96,141,90208,3,1,2,6,Gold
4258,4306,5,159,761425,1,1,1,3,Platinum
4259,4307,107,32,23267,3,3,4,10,Silver
4260,4308,200,68,168488,4,2,2,8,Gold
4261,4309,159,19,18270,4,3,4,11,Bronze
4262,4310,72,200,259807,3,1,1,5,Platinum
4263,4311,37,32,58936,2,3,3,8,Gold
4264,4312,29,8,16132,2,4,4,10,Silver
4265,4313,2,134,333049,1,1,1,3,Platinum
4266,4314,28,42,77159,2,2,3,7,Gold
4267,4315,327,43,29359,4,2,4,10,Silver
4268,4316,237,15,34683,4,4,4,12,Bronze
4269,4317,90,13,35362,3,4,4,11,Bronze
4270,4318,32,26,57308,2,3,3,8,Gold
4271,4319,30,31,87133,2,3,2,7,Gold
4272,4320,212,21,93740,4,3,2,9,Silver
4273,4321,6,114,259122,1,1,1,3,Platinum
4274,4322,230,2,57600,4,4,3,11,Bronze
4275,4323,23,64,148223,2,2,2,6,Gold
4276,4324,95,19,59082,3,3,3,9,Silver
4277,4325,5,272,797952,1,1,1,3,Platinum
4278,4326,265,10,19065,4,4,4,12,Bronze
4279,4327,5,271,711257,1,1,1,3,Platinum
4280,4328,45,242,699346,2,1,1,4,Platinum
4281,4329,219,5,10369,4,4,4,12,Bronze
4282,4330,58,30,92055,3,3,2,8,Gold
4283,4331,13,164,850894,1,1,1,3,Platinum
4284,4332,14,86,351156,1,2,1,4,Platinum
4285,4333,193,124,246358,4,1,1,6,Gold
4286,4334,84,37,74532,3,3,3,9,Silver
4287,4335,334,1,44172,4,4,3,11,Bronze
4288,4336,72,104,259102,3,1,1,5,Platinum
4289,4337,31,49,107479,2,2,2,6,Gold
4290,4338,3,61,131110,1,2,2,5,Platinum
4291,4339,219,88,201305,4,2,2,8,Gold
4292,4340,49,6,51618,2,4,3,9,Silver
4293,4341,11,104,256324,1,1,1,3,Platinum
4294,4342,73,78,268376,3,2,1,6,Gold
4295,4343,8,175,349993,1,1,1,3,Platinum
4296,4344,32,4,67870,2,4,3,9,Silver
4297,4345,123,47,101157,3,2,2,7,Gold
4298,4346,19,8,14880,1,4,4,9,Silver
4299,4347,312,21,43103,4,3,3,10,Silver
4300,4348,88,15,693336,3,4,1,8,Gold
4301,4349,51,98,64097,2,2,3,7,Gold
4302,4350,90,6,13054,3,4,4,11,Bronze
4303,4352,40,118,285781,2,1,1,4,Platinum
4304,4353,25,42,274078,2,2,1,5,Platinum
4305,4354,173,134,333814,4,1,1,6,Gold
4306,4355,44,21,39209,2,3,4,9,Silver
4307,4356,141,13,21484,3,4,4,11,Bronze
4308,4357,26,61,199538,2,2,2,6,Gold
4309,4358,74,46,97001,3,2,2,7,Gold
4310,4359,139,1,2722,3,4,4,11,Bronze
4311,4360,367,7,21576,4,4,4,12,Bronze
4312,4361,39,11,33295,2,4,4,10,Silver
4313,4362,3,166,414937,1,1,1,3,Platinum
4314,4363,10,3,26980,1,4,4,9,Silver
4315,4364,31,11,23258,2,4,4,10,Silver
4316,4365,44,14,44326,2,4,3,9,Silver
4317,4366,59,8,14201,3,4,4,11,Bronze
4318,4367,74,9,20462,3,4,4,11,Bronze
4319,4368,278,10,20480,4,4,4,12,Bronze
4320,4369,181,7,10774,4,4,4,12,Bronze
4321,4370,9,12,25177,1,4,4,9,Silver
4322,4371,4,754,280608,1,1,1,3,Platinum
4323,4372,44,70,262820,2,2,1,5,Platinum
